55.ox
oo.oo.........oo...o..o......oo...o.o..o...o......o.ooo....o..o..oo.........oo.........o..o....oo..............ooo.o...o.............o.....o.o.o...o..o.....ooo....o...o.ooo....o....o......oo.....o...oo.o....o........o.......o......ooo..oo.............o..............
....o.......ooo..o..o.........o.o...o.o.o.o...o..............ooo.....o.o.o...o......oo........o......o.........o....o...............o.o..o.....o.......o.oo.o....................o...o...o.o..o....o....o.o..oo.......oo.o.o..oo...o.o.....o..oo......o...................
............o..oo..o...o........o....o.......oo.........o.......o.o......o.....ooooo.oo.........o............o.o...........o......o..o...ooo.o....o....o.............................oo...oo..oo.o...o.ooo...oo.....o......o.....o...o......o.......o.....o...o.....o.....
......o.o............o.......o..o..oo..o.o........o.o.o....o.o.o.o..o........o............o...o....o..oo...........o....o....o.o....o......o..............o......o.o....o...o.o....oo....oo.ooo..ooo.o....o..o.o.o.........o..o.......o..o..o.......o.oo........o.....o...
..o..........oo...o......o.......o...oooo.o...........o.....oo..............ooo......o......o........o........o.........o...o.oo............o.ooo....oo......o..o.o.......o..o..........o.....oo...............o....o.o.........o...o.o..oo.....oo.o.............o..o....o
.o...ooo......o...o.o.o...o...oo..o.o....o...o..oo.o.ooo....o.o...oo.o...o.oo...................oo.o.o.....o.....................oo...o.........oo..oooooo.o....ooo.o........oo..o.o.........o........o....oo.o.o.o................o.........o.....o..o.o.........o.......
.o.....o.o.......o.....o....o.................o..o..oo...o.o..o......o..o........o..o..o.....o......o.o.....oo....o..oo...............o..oo........o.o.....................o..............o.o..............o...o.........o............o.oo...o.oo......oo.....o...o.......
o...........o.o.o.o...........o.................oo..................o.o....o..........o.............o.o......oo....o.....o.......oo.o......o.....ooo...oo...o.....o...o.............o............................oo......ooo...o.............o.........oo.........o..oo..o
...........o........o........o.......o...o......o...o......ooo..........o..........oo......o..o....o..............o.oo...o........o.o....o......o....o.....o.o.o....o.o.....o.......oo..o.o....o.o..o...o..o......o.o....ooo..o...o.oo.....o.o.....o...o..o...o......oo.o.
.....o..o.o.....o...o.o.....o......o........o..oo..........o...oo.........ooo.oo....................o..o.......o.......o...o....o.....oo....................o....o.o....o...o.o..o.o........o..............o....o..o..o....o..........o...ooo.........o..o.......o........
..o..........................o...o...o..o......o..o........oo...o..o..o.........o..................ooo.o......o......o.......oo............o..o...o...o.o.....o..oo.............oo....o............................o.o.o...o....o..o.....o..oo..o......oo.......o.o.......
.....o...........o....oo...........o.oo...oo.o........oo.oo.......o.o........o.....o...o......o....o..o.....o....o...........o.............oo.........o....o.........oo..o.oo..o......o...o..........o..o.oo........o............o..o.o...oo.............o............o..o
...............o..o..o...oooo......o.o...o........o..oo.oo.o..............o.............o......o..o...o.o.........o......oo.oo...o..o.........o....o....o..o.o....o..oo.o.o..o........o..........o............o..oo.o...o.oo.o.oo......o....o....oo........o.........o....
..ooo..o....oo..oo...o....o.o.oo....o....o.....o......o.o.o...o..........o..o..o....oo....o......o.o..oo.....o...o...o.......o.o..o.......o.ooo.o....o..o.oo........o.....o..........o...o..o..o...o........oo......o..o.o....oo..oo.oo........o.o..o...............o..o..
.....o.....o..oo.oooo..oo....o..o...o.o....o....o......oo.o....oo..o...o...o..o.....o..oo..oooo.....o.o...........o......o.........o.....o.oo...o....o..o.........o....................o....o........o.......o.oo.......o...o....o..o.o.....o..o.................o...o....
..o......o......o...o....o.o.o......o.........o.....o..o.......o...oo......o....o...oo.o....o.o...............o.........o.....o...o.....o.o...o.o.oo.....o..............oo..o.....o...oo.............o..oo...oo..o...o..o.o...o...............o....o.o.........o..........
...o.....o..o.....o..........o..o....o........o.o..........o...oo.......o............o.....o..oo.........o....o...o....o...o.............................o.o....o.o.....o..o...........o.o.oo...............o......oo...o.oo......o.o.....o..o......o.o.o....o....o.o.o.o.
oo.oo..................o.......o......o..............o..oo.............o.o.o...o...ooo.o.....o.o...o..o..o.o.o..........o...o......oo......o.......oo..............o..................o.......o.o..ooo..oo.o.....o.o...o.......o...o.ooo..........................oo..ooo.
..ooo....o.o..o....o...................o......o...o......o...o...o....o....o.......o..o....o....o...oo...o....oo...o.o..o.....oo.ooo......o.....o...o...o..........o.o.....oo.......oo.o..oooo.......o....o..o......o..o.o..o..........o....o....o...oooo..........o......
...................o.....o.....o...o.o.............o....oo...o......oo.o..o...o.........ooo..o...oo..o........o.o.....o.......o....oo..o.o...oo.....o..........o.........oo..o...o.....ooo....o..o...o..........oo..oo.............o.....oo...o....o......o........oo..o..
.o....o....o..oo..o...........o.....o.........o......o.....o..o.o...o..................o.oo..o.ooo.o..o...........o..o..o.o...............o.....o...............o..o.....o.o.o..o...o....o...o............o...o.o..........o........o....o..o...o..o........oo..o.....oo..
o..o.o......oo..oo...........o.....o.....o.......o.ooo.....o..o....o.....o.o..o....o..o....o.o.o.o...............o......o.o..o.....o........o.......o......oo.................ooo........o.oo.oo.......o....o...ooo....o..o.....o...oo.oo..oo...o..o.o..........oo........
....o......o.o..o...................o....o.....o.o.o.........o.oo...o.....o.......oo.....o...o.......o....o......o..o..o...o....................o.....oo.o.o....oo........o...o.....o..........o...........o....o.o.o...........o.o.............o.........oo.o..o.oo...oo.
....o...oo............oo......oo..o.oo...o....o.................o..o.o.............oo....o..o......o....o...o..o..oo...o...o.....o........o........o..ooo..o.................o...o....oo....o.o..o.o.o....oo....oo...o.o..oo.......o......o............o....o..........o..
...o.......o.....o..........o...o...o...o..oo.......o..o..o.o..o.....oo......o....oo......oo..o......o...o...........oo.o......o...o............ooo......o..o...........o....o...o.....o....ooo....o.....................o...o......o.......o...o.....o..o.....o.oo......o
.o..............o.........o...o..............oo.........oo....oo..o.oo....o.....oo......o...oo.o.....oo..o...oo....o...o..............o......o........oo......oo.............o.o.o......oo.o..ooo...o................o.o.o...o.oo.....o.................o.o.o..o..........
..ooo..o...o......o..........o.........o......oo.o....o......o..o...........o............oo.o....o.....o...o....o....o.ooo...............o......o......o......o.....o...o.....o.oo......o...o.oo.....o.....ooo.o.o...o...o........o........................o.........o....
......o........o......o.o.o.........o........o...o....o..............o..o..o.....o...o...............o...o.o.oo....oo..o....o..o.........o....oo.......o...ooo..oo...o.......ooo......o...o.o...o.....oo..o....o...o...o...o.o...o..o........o.........o....oo............
..o......o........o.........................o.....o..oo.....o.....o.......oo.......o...oo.oo...o...o..oo............o.o.................o.oo........o....ooo...oo....o....o.o...oo..o.....o.....o....o.oo.oo..........oo....o.o..o.....o..o....o.....o........o.....o.....
..............ooo....o.........o...o.o......ooo.oo...o.....o...o...o...oo.o........o..o....o.o.................o..o.o....o.oo.oo.....o.oo.....o.........o...oo.o.o....oo.....o.........o..o..............o..o.o...o.o.o....o....oo..oo...o...oo.....o.oo...oo.............
..o...oo.oo...o......o..o...............o.o.o.............o.......o.......o..........oo...o..o....o...oo......oo..oo.....oo.....o.o..oo......o..o..o........o....o.oo.....ooo......o.......oo...o....o..o...oo.........o.oo....oo........o...oooo.....oo...........o.o..o.
o.o..o......oo..............o........o...o.o....o....o....oo.oo..oooo.o.oooo.............o.o..ooo.o....o...........o..o...........o................o.......o....................o..........o...o..o.o....o..o....o........o.o..o...........oo.o..o..o.o..oo.......o....o..
o...o...o..o.oo...........o..........oo..oo.........oo..............o.....o..o..o.......o..o.o..o..o..o......o......o.o..o.o...................o..o.oo.........o...o..o...oo..o.....o.o.o..o......o......o........o.....o...oo.o...........o.o....o..o...o..o........o....
.....o..........o.....oo........o.o.....o..o...o..o......o..............o...............oo..oo............o...oo.........o........o.........o.oo..............o.................................o...o...o.....o...o..o..o.....oo....o..o.o..oo.o........o......o..........
........oo....o..oooo........o.................o..oo....o.oo.......o..oo.......o.o..o.o....oo...o....o....o........oo..o.o.......oo.......o.....ooo.....o.....o..o.....o.o.......o.o..........o.....oo...o..o..o......o......ooo....o........................o..o.........
oo.....o........o.o....oo................oo.........oo.oo...oo..oo....o...o..oo.o.............o.oo.ooo.........o..........o...o..o..o....oo....oo......o........o.....o...o.o............oo........o.o.o....o....o............oo.....o.o.o....o...o.o...o...o......o.....o
.o.......oo.o....o..........oo....o............o..............oo.oo.o.oo..o...o.o.....o..o.....oo......oo.......o.......o.......o.oo..o..................o..o.o..oo..o....oo........o....o..oooo........o......o............o.....o.ooo..o.o....o.o.o...oo.o.....o..o..o..
o.........o.ooo..........oo..o....o...o.oo.......o..ooo......o.o.......o.o.....o...o........o.........oo........oo........o...........oo..o.o...o......o...o..o.........o..........................o..oo.o....o......o....oo...o.o..o..oo.....o...o.............o......o.o
....o.....o.....o.o.....o..o.....o.......o....o....................o....o............o......o.....o.........o.............................o..........o...oo......o...o.........o.......oo.o........................oo.....o.........o...................o..oo...o.....oo..
...o.................o.......o.o....o...o...o.........o.....o...o.....o..o.......o......ooo........o...oo.....ooo.o........o.o.o..o......o........o.................oo.o.oo....o.......oo.o.o.....o.............o...........o..o.........o........o.o..............o..o..o
...o...........ooo...oo..............oo....o..........................o.........o.o...oo......oo.o.o....o...o.o..o..o.o..........oo......ooo.oo...........o....ooo...o................o..............o......o..o.oooo...o....o...........o...............oo.....oo....o...
o....................o.......o.o.o...o....o....o..........o.o.......o.....o......o....o...o....o.....................o.o..o..o.....oo.o.......o......oo..o.....oo..o.....o...o..o.o.o..o.o..o..o.o..o.ooo..........oo...o........o.o..........o.........o.o....o..oo..oo..
o.o.o.o....o.oo.....o..o.o.o..oo...oo....o..o.......o..........oo.o..o.ooo....o..oo.....o......o....oo.o.....o..o..............o...o...oo.....o..o.........o...............oo...o.....o.....o....oo......o..ooooo.o..o.........oo..o......oo...o.o..o.oo.oo..o............
.....o....o.........o..o.o.o...o.....oo...o.........o...oo.....o.o....ooo...o.o.................o....o..........o..o...o.oo.o........o..o...o..o.o.....oo....o......o...o.....o......o..............ooo.o.o.....o.o...o..o.......o.o.o..........o....o.o.............oo...
...ooo...oo.......o..o.oooo......o......o..o.o...o.oo..o...ooo..o.oo...o.oo.......o...o..o....o......o....o......o........o.............o.....o..ooo.....o....oo......o....o.o....o....o......................oo.........o.o.....o......o........................o........
.o.....o..o.o....ooo..oo..............oo.o..o......oo...o.....o.o..oo.......o....oo.o.........o.o..........o.......o.o...o.......o........o....o...o..o...oo......o..o........oo.o....o.......o.....o.o......o...oo.....o.o...........o.......o....o.....o..o.o........o.o
..........o.........o.ooo..o...o.oo...o.......ooo.o...o.....o.....o.oo....o.......o....oo.........o..o..o.........o......................o...oo.o..o........o..o.o....o...o.....o.......o.......oo.o..o...o.....oo..................o...o...........o.o....o.......o....oo
...o..........o....o............ooo....o.....o..o....o....o...o.o...o.....o.oo..........o.o...o...o........o.o........o.....oo.o.........ooo.o.....o..o..oo....o..o....o.o...o..o..o........o...o.oo.o......o......o...o..o....o...o..o.o.......o..........o.............o
o......o...o....oo.o.o..o.ooo..o.o.....o..................o.....o......o...........o..o..........o..o.oo...o......o....o........o...ooo...o.o.oo.......oo.o.o......oo...o...........o.o.o..o.o.o.....o..o.............ooo.o.o....o...o...o....o...o...o.............ooo...
..o...o........o....ooo....o..............oo.............o..o......o.o....oo...o..................o.o.o.o.......o.o..o.o.o.....................o...o..o.o...o.ooo......o...........oo.ooo................o.o....o...........o......o.o.....o....o.............o....o.oo...
..............o.....o.......o.o..o.....oo....o.....oo.oo...............o......o.o....................o.................o.o.o...............o..............o...o.o..o.oo.......o.o....o...oo...............o.......o......o..oo..o.....o.o..oo........o...o........oo....oo
.o.o.........o..oo.....o..o.o...o.o...o...o...........o.o........oo...........o....o.............oo....o.......oo...o...o..o.o..............o.o.....o......o..o.....o..o......o...o.........o.....o...o....o...o.....o....o.o..o...o....o....o.oo..o....o...............o.
............o...............o...oo.....o..oo......oo..o..............o....o..o...o.o..o....oo..o..o.....oo.....o..o.o...o...ooo.........oo...o..o....o...o......o...................o.oo...o........oo.....o...o............oo...ooo....o...o.....o.o.....o.............o.
...o.o......o........oo..o...oo.o..oo.o.o...o...o..o.........o...oo...o.........o.......o...o....o...o..o......o.o....o...oo...oo...o.........o....ooo...o.....o...............o..................o.......oo.o.ooo....................................o...oo.o....o...o...
...ooo............o..o...o..o.............................o.......oo....o...o...oo..oo..o.......o.......o..o.....o.oo..o..........oooo.o......oo..o.o...oo....o..o........o.o...oo..ooo.....o.....o....o.o..ooooo.o..o.o..........o.o..o...o.........o.o...o..o....o....o.
