42.ox
.o......o.o.oo.......
.o...o..o..o...o.....
.......o.....o...ooo.
.o....o.o.......o....
....o..o........o.o..
.........o...........
..o....o.............
o....o.o....o....o..o
..o..o...............
o.o........o...o.....
......o.........o....
..oo..o..o.......o..o
o..ooo.ooo...........
.ooo...o..o..........
....oo....o..o.o.o...
oo.........oo........
o.....o.oo.oo........
..........oo.o.......
..o...o..o...o....o..
................o..oo
..o.o................
.o..o........o.......
.......o.......o..oo.
...o.....o....o..o..o
o..o.oo..o..o....o...
..o.......oo.........
o...o.....o..o....oo.
......oo....o...o....
o..o....oo..o....o...
..............o.....o
....o.....o.o......oo
.o.....oo...oo....o..
...ooo..oo.o.........
..oo.......o..ooo....
.....oo..o.o.o.o.....
........o.........o..
..o....o...o..oo..o.o
o.o.................o
o..o....o.o..........
.o...o........o......
.o....o.o..o.o......o
.o.o.................
