162.ox
...o.........o......o..o........o..o.........................................o.....o......o.o.................o....o.............o...o.....o...................o.o...oo...
..........o......o......o...........o.........oo....o....oooo...oo..o.........o.o.....o..............o...o.o....oo.....................................o...o.....o........
..o...............o.....................o..............o.o.........................o.....o.....................o............o...oo........o...........ooo.....o..o..o....o
...o...o..o....o...........o..o.........................o.........o.................o.o........................o........oo.o......................o.....o....o............
..o....o....oo..........o...............o..o..........o.........o..o.................................o.....o....o...oo..................o........o......o.....o..o.....o..
.....o..o.o.....o...o.....o..o...................o..o........o........o..o.o............o.....o......o.......o.o................o........o....................o...o.......
.........o.........................o.o....o...o....oo..oo................................o.............o.....o.oo.................o..o.o.....................o...o..o.....
.......o..............oo.o........o...o.oo.............oo..o.......o...................o..o...............................o..oo.................o.......o.o...............
.....o..o..o........................o..o..o........o......o....oo........o.oo.....o.....o..oo....o......o........o.o..............o.........o.................o...........
...o........o........o..............................o..o...o..........o.o..............o..oo..oo.....o.........o.....o......o..........o.........................o.......o
.o....................o...o...........o.........oo......o................o....o....o...................o...o....o....o.o..o.......o....o.................o..........oo....
................o.......o....................o.o............o.................o............oo........................o......o........o...o...........o..........o.........
..........o.........o......o.....o....o.....o......o.................o......o.......................o.o.....o....................o...o..............o.....o..o......o.....
.............o..o............o.........o.......o....o.....o....................o.....o.........................oo.....o...............o...o.........o....oo...............
.........o............o.................o....o............o..............o........o.o..o...oo..o....o....o...o...o................................................oo......
.o......o...........o.o.oo.....................o...o........o......o....o.o...o....o.ooo.o...................................oo...........o......o...o...oooo........o....
..o...o.......................................o..................o.....o.o.o...............o......o..............o...oo.o......o..o.o...................o.......o..oo.o...
........oo.....o..................o...........o.o.......oo...o.......o..oo........o..o..o................o.o..o.........o..o.............o..........................o.o...
............oo..............o.........o..............o..o..o..o.....oo...o...o........o...o.....o....................o..o......o..................................oo.o.o..
...o.......oo........o.o.......o.....oo...o.o...o....o..................o............o.o...........oo..oo....o..........o..................o.....o.......o...o............
.o........oo.......o....o...o........o..................................................o.......oo.oo..oo.o.....o..............o.....................o...o..........o.....
......o..o.........o...........o....................o..o.....oo...................o..o....o...o..o.....o...o......o..........o...............oo..o...o.........o.......o..
oo......o............o..............o..o....o......................oo.......o...........o.............o.....o......o........o....o................o.........o.....o..o....
o......o....o.............o.......o..o.............o.......oo............o...........o....o................o..o.....o........o.o.............o.....o........o...o..o.....o
..o..............ooo.....o..................o...............o..o..o...o...........o.................o........o..o.o.....o..o...o.o.........o.o................o.........oo
.oo....o....o...........oo.....o..o......o....o.......o...o.o.....o.........o.......o....................o.........o......oo.....................o.....oo..o..........o..o
...oo........o.oo...................o......o..o....o.................o.o..o..o..o...o.o.o...oo..oo.o........o.....o...o.......oo..........................................
..o....o..o.............o...oo.......o........o.oo.........o......o......o......o....................o.....o.oo.....oo.o.o.....o...........o....o...........o........o....
.o.o..............o.....o...............oo.............o......oo..o...............o...........oo.oo......o........o.oo.o.........o...........o...o.o...o.o..o....oo..o....
...o............o.......o....o..............o..o.....o....o..oo..oo...................o...o..o.o......o.........o......o.o.............o.......................o..........
....o..........oo..............o......o.................o..........o..............................o......................o.o....o..............................ooo........
o......o......o...........................................oo......o..........o....o......o..o.....................o.....o......o.o......o.....................o...o......o
........o..o.....o...o....o.......o................o................o..............o...o.o.o.o...........o...................o..............o.....o.o.....................
.o.o..o...............................o......o...o......o....o.o..o..o..o....................o..o.......o...o............o.....o............o..........o........o....o....
..................o.....o........o.........o....ooo......o...........o.........................o.................o.....oo.........o.o...o......o...........o....oo........
..............................o...........o......o..o......o........o......o....o.........o..o..........o...oo...............o..........o.........................o..oo...
.o..............................o....o...o.......o......o..............o...o..............oo..........o.o.......o...o....o......o....o...o............................o...
..............o.......o..........................o....o.......oo.........o.......o...................o.........o.....................o................o..........o........
.....o..o.o...o..o...o........o........o...o......................o......o.............o.........o........o.................o.......o.oo..o...............o...............
....o..o.o..............o..............o....o..o.o......o...o...o...........................o....o..o..................o.......oo................oo...........o.o.........
.o...o...o...o...o.o.o..........o........o....o....oo...oo.............o...o....o........o.......oo.....o......o.......o....o..........o.............oo.o..........o.....o
o......................................o....o...o....o.....o.......oo.......................o.......oo....o.............o.........o.........o..o...................o...o..
.....................o.......o..........o.o...o...o.o.o..............................o.......o..........o.....o......o.....o......ooo.........o......oo........o......o...
........o..o......o.....o.....o..o....................o.o..................o....o......o.ooo...o..o..............o.............o....ooo..........oo..............o...o....
...............o...o.................o............o......o.o.........o.o........o........o.........o..................o................o................o............o...o
......o.....o.................o..............o.............o.....o...o.................o......o........o.o.o...o....oo......o...o................o..oo...o.....o.o........
............................oo....o...o........o.o..................oo........o.............o....................o.......o.............o......................o...........
.....................................o......oo.........o.....o.....o.........o........o....................oo.........o...................o.........o..o.o..........o..o..
.........o.....oo.....o...o...........o........o...........o...........o...o.........o...........o...................o.o...o....oo......o......o...o.................o.oo.
..o.........o.............o.................o...............................o.......oo.........o....o..........o...o..........o............o....o....o...o.....o...o......
...o........o.........o........oo....o........o............o............o...o......o...........o.o....o.o......o...o......o.........o......o..o............o..........o...
....o..........o..o........oo.o..........o.......o.o.......o......o................oo.oo........o..o..o...o..o...o............o.........o......o..........................
.....o.o.......o.........o.....o..o......o..........o..o..o............o.....o.........o....o..........o...oooo.o........oo......oo...................o............o..o...
....................o..o.o........oo................o......oo................o..o..o.....o...........o......o........................................o........o...........
oo...o...o.o.o.....o...o...o......o......o....................o..o....o.........o.................o.o.o.....o....................o.o..o....................o.o..........o.
...o.......o.........o......o........o.o.........oo...........o............o....................o...........o.o.o.................................o............o..o.o.oo..
.........o.................o.........o.o....oo.......o..o.........................oooo................................oo..............o................o...............oo.
........oo..............o...o.....o...o........o...o.................................................................o.......o.....oo.......................o.....o.oo....
.o................................o....................o...ooo..............o.o.........o..o.............................o.o...o..............oo..........o.o.....o......o
............o......o...........oo...............o..o.........o......o..............................o.....................o..........o...................................o.
o......o....o.............o........o...............................o...o........o..........o.....o..o...ooo......o.........o.o...o................oo...........o.o.o...o..
.oo.....o.o....o.........o........o................o............o.........o.o.........o.................o.........................o............................o..........
...o.............o.......oo.o.....................o........o...o..o.oo..o............o.......o..o.o...........o.....o.............o............o.o....o........o........oo
..........o.................o.....o.o.o.....o.o.o....................o..o..o.....o......................o.....o........o......o.........o......oo.....o..o.........o..o...
o...o....o......oo.....o..........oo...o.o......ooo..........................o...o......o.....o....o..............o............o..........o.o...........o....o.o.o........
.......................o....o............o......o................o..........................................o.o....o.....oo....o...o..o............................o......
......o.oo.o.o....o...................................o...o..o.....o...............o...........o.......o..o................o....................o.........o............o..
........o....................o...o.......o............o......o.....................o.....................o.........o...o..o...o....o.o......o............oo...............
..............o..o.oo...................................o....................................o.......o....................o.....................oo.o.o..........o....o....
o.o..o..o............o.....o........o...oo.....o..o..............o................o................................o..........oo.............o......o.o.......o.....o...o.
........o.o.........o........o......o...........ooo.................o..........................o........o.................o...o..........................o..o.............
o...........o..............oo......o..oo........o...........................oo........o..................o.......o....o......o....................o....o.......o..........
..................................o........o.....................o..o.......oo...o...............o.....o.....o.o........o.o..............o.............o...o..............
.o................o.o..o....................................................o...o.......o.............................o.o..o......o..o...oo..........oo....o.............o
.................o.........o..o......o.......o..............o.......o.........o.....o..o.o...o....oo.o......o........................o..........o.....o..........o..o.o...
...o...o................................oo........o..o.....o......o......................o..................oo.o.......o..o..........oo.......o..o...............o...o....
....oo..........oo...............o...o.o...........o...o..o....................oo...o.............o....o.....o......................o....o..o.o..oo......o.......oo..o....
..o.o......................o.......o..o....o......o..o......o....o.......o........o...............o..o.......o.......o........o.....o...o......o..oo....o.................
.................o.....................o......o...........o.......o..o..o...o....o....o....o....o..o..o.......o....................o.o..o..o................o............o
....ooo...o.o................................o......o...o......o..........o..........o.oo.............o..oo...................o...............o...........o.o..o..........
.....o......................o...o...o......................o......o..o...o..o...............o....o.........o.......o........o.........o................o.....oo........oo.
.......................o......o...oo.o..o..........o...........o.o.o.o.......o...................o..........................o...........................o........o.....o..
............................oo...o...o..............o.oo..........oo...............o......................o...o..o..o.o....o...o..o.....o...o....o.......o......o.........
o...o.o...............o.o.................o..o..o....o.....o.........................o..o.o.........o....o..........o....o.....o.o.o.................o.o.................o
..........................o.....o..o..o..o...o...o..........o.....o.............o......oo........o..................oo...............o.oo...o.............o........o..o...
o....o.......o.....oo.............o....o.......oo........o..o....o...o...................o....................o............o...oo..................oo.oo..................
...o..o......oo..o..o....o............o..o...............o....o......o....o.......o.........o...........o...o..............o....................o.........................
.......o..............o......o.oo...o....o...............o..o...........o......................o......o.o.......................oo..oo..........oo...........o.o....o.....
...o.o....o.......o.......................o.o............o...........................o.......o.....o..o......o.o.........o.o...........o........o....o............oo...o..
.....o..o............oo......o...o........o.....oo................................o............................o...o...o..o........o.o...........oo...........o...........
..o....o...o..o.................o....................o.o...........................................o........o................o.o.....................o....oo..............
..o.........o..........o..o.....o......o...............o.........................oo..o.....o..o..o...oo...o.o...o.......o................o...o...............o..........o.
...........o.....o.....o...o.......o....o..........o...........o............o..o.......o........oo....o......o............oo....o...............o....o..o.o..o..........o.
.oo..........o.........o...........o...o....................................o....o.o...o..o....o.o....o..o.....o..o.....o.o...........o.o....oo......................o....
.o...o.....o..o..........o.......o.......o...o...o........o.............................o.....o.oo.............o............o.o...o..o.....o.......o..o..........oo.......
...o...o...o..............o..o.........o............o........o....o.......o...o...........o.....o...o.........o........o..........o.........................o...o.o..o....
o....o.........o.....o........................o...............o.....................o..o......o....o............o.ooo.........o.o...........o..o......ooo....o............
..........................o...o......oo...................o......o.....o................oo...........o.........oo..o..o.....o....o..............................o......o..
ooo.o..o.......................o..o..........o..............o.......o....o.......o.o...oo...o.......................o............o...o....o......................o........
..o...oo.o...........o......o...............o.........o...o.........................o...o.o....o.....................o..........ooo..o.......o.oo.............o....oo.....
......................o..o.............o..o.........o.....oo...............o......o.......o.............................o...o........................o...o................
..o......o.o..o..o.........o....o.........o.....o........o...o....o..o...oo..o......o.....o.............o..o.......o..........o..........o.o..............o......o......o.
...........o.o........o.............o....o..........................o......o.....................o...oo..o..o......o.o..............o.......oo.......................o....
...............o....o...o..o.............o........o....o...ooo.o...oo....o..o.................................o..oo............o...o........o...o.................oo......
ooo...ooo..................................o........o.......o..o............oo.........................o.......o.....o..o.o.o....o..o..o..o........o.....o....o......o....
...o..o......oo.............o..o....o.oo......o.o....o..o...........o.oo..........o...................o.................oo......................o............o......o....o
......o...................o.............o...o..........o......o.......o......o.o...................o........o..o.o.o........oo......oo..o.......o......o..o..........o....
...o..............o.o.....o...o...............o................................o..o.........o................o........o........o..o......o......o.........oo..o......o.o..
o...o...o..........ooo..o...o......o.o..o.............oo.........o....................................o..o.o...o.......ooo.....o.o..o...o..................o..o...........
..o..............o...o......o...o..................o..ooo........o.......o.o.o......o..........o.........o...o.....ooo..o...oo.....o..oo.....o......o....o........o.o....o
.........oo.o..o.oo....o..o...........o.o.....ooo....o........o...o..................o...o....o....o..o.........o...........o....o............................oo........oo
........o..o.o...o.....o...oo....oo.o.......o.......o....o..o...o..........o..o....o........o...o....o.o.............o............o.....o...................o...o.........
........................o...o............o................o....o............o...o.....o...o...........oo......o....o..................o.............o....o.......o........
o....o..o....................................oo....o......o........................................o.oo.....o.o......................oo.........o......o......o...........
.................o...o..o....o......o...o......o.o....o.o......o..........................o..........................o........o................o.ooo................o.....
.o.............o..........o....o....o.o...o...oo....o.o............o.......o.....................ooo.......o..oo........................o.o...............o.o.......o.....
...o............o....o.............o...o........o.........o.........o......o.o............o...................o........o....................o..o.....o....o....oo........o
.......oo....o...o...oo......o.o...o......o........oo.......o.......o....oo.........o.o..........o..............o...........o........................................o....
.........o...o......ooo..........o.................o...........o....o...........o..........oo......o..o................o.....ooo...o...................o...o......o.......
o....................o.oo.o.............................o...o..............o......o...o...o..........o..........o....o...........o...o.........o........o............o..o.
.....o......o......o....ooo..o....oo.....o.........o.......o.....o.............o.....o..............o..oo.............o..................o......o............o.....o.o....
......oo..............o.........o...o.......o.....................oo.........o.o............o..............oo........o.......oo...o..oo..........o......o.....o.....o.....
.....o...o.....o.o.........oo.............o......o.................o..............o.....o...o.....o...o........o.......o....o.......o.o..o.......o....o..o....oo..........
..............o.......o...............o............o.o................oooo...o.......o...o........o..o.......o.............................o.o...........o.........o......
o..o........................o.oo.............o...oo..o.............ooo..........o...o..o...o..o......o.....o......o..o..................................o.............o...
.oo................oo...........o..........o......o.......o....o...o...oo.o.....o.........oo..............o........o...........o.................................o..o...o.
...........o.....o...o...............o..........o.............o...............o....o..oo.........................o......o.o..o......o.......o....................o........
.o.o..o........o.oo............o..o.o.....o.........................o.oo............o.o......oo.....o.......oo.......................o...............o...o......o.........
........o............o...o..............o..o..o...o..................o.........o.....o.................o............o..o..o...................o.........o.................
........................o..o.o.....o.............o.o...o.....o.......o.....o........o.......o.........o...............................oo...o.................o........o...
oo..................o.......................o..o....o..........o...........o....o...oo.......o....oo....o....o................o......................o.o.......o.....ooo..
...o............o...............o...........o............o...................o..o.........o.o.o.......................o....o....o....o.o..o......o.......o..o..o..........
....o.oo....o....................o.............oo.................o..o....................o........oo.......o..o.oo..o............o...o......o.......o..o..o......o.o.....
.......o..............o.o..o.o............o...o....................o..o..............o.............o....o.......o......o......o.................o......o....o.o........o..
...o.o..oo.......o......o..................................o...........o.......o.o........o....o.o.....o.oo...............o......................o.......o..............o.
.....o.....o.......o.........o.o.....o................oo.....o.........o...o.....oo............o.o...o...o.....o.................ooo..................o...oo.........o..oo
.........o...o................................o..o................o....o....o.........oo.....................o......o.............o...o............o..o..........o...o...o
..........o.........o...o....o..o...oo..o.......o...o..o..o...............o....o.....o.o........o.o..o.o.......o..........o....o..........................o.o...o......o..
...o..o...o...........o..oo.....o..........o...o.................oo...oo.........o...........o.....o.........o........o..o...........................o................o...
.........................o............o.o...o.....o.o...........o.................o..............o........o......o..o.oo...........................o.o........o.o.........
.............o...o.o......o...o....ooo..........oo.o............o................oooo..................o..o.......ooo...o.........oo......................................
........o......................oo.....o...........o.oo....o..o...o..o..........................o....................o.........o..o......o........oo.....o.......o..o.....o
.......o.............o....o..o..................o...................o......o......o.....o..o.o....o...oo..o.........o..............o.....o...........................oo...
.......o......oo.o.oo......o..............o..o...o...o................o....o....o..o..o.....................o...o....o.................o...o......o........o..............
...............o...................................o.................o.......o.......o.....o.............................oo...o......oo.o..........................o......
......o...............ooo...................o..o.o.....o.......o............o....o.............o.........o....o..o......o...o....o.....o..o.o.......oo..o.......o.........
.o..o..........o....o......o...ooo.....oo.....o.................o......o.......o...................o..o...o..o...........o....o......oo.....o.....o...........o...........
...........................o............o......oo.......o....................o..............................o................o.o.............o...o.......oo...o....o......
.o....o.............oo......o..o.......o.......o......o......o..o.oo..........o.............o..o..........o....o....o...........o........o...........o.........oo........o
...o..o......o........o.....o.........oo.....o......o..........o..o....o..o...o............o...o....o....o.o.......o....o.o.........oooo..o............o.o...o.o..o....o..
...................o.....o......oo..oo.........o..........................o...o.....................o.....o...oo...o........o......o............o...o....o...o............
o...........o....oo..o...o..............o....o........o......o.....o.......o...............o..............o.................o.........o..o................o.......oo......
........o.o.o..oo.o.....o.o......o...oo....o.........o.......................o....o....o.o........o........o...............oo.................o..o..o.............o..oo...
..............................o..o.......o...oo.........o.......o.o...o..................ooo............o..........o...o..o....................o..o...o.....ooo.......o..o
..............o..o............o...........o..o.............o..............o....o...........o................o........o...........oo........................o..o...o....o..
..................o..o.o.....................o.......ooo.............o.........o...................o.........o......................oo......o.............o..........o....
............o...........o...oo.........o............................................oo...o....o...o......o..o.......o...o....o....o...o.o....o.........o........o......o..
........o.......o..........o............o..............oo.....o..........o...o.o.....o..o................o.......o..o..o..o.o.......o......o..o..o..oo.................o..
..............o....oo....o........o.o.......o.....o...........o...o...................o................o.................o.....o.............................oo...o..o....
.o............o......oo...........................o..........o...........o...oo....oo..o........oo..o......o.............o..............o.................o........o......
.o...............o.o.o...o...o......................o...oo..........ooo......o..........ooo......o.....o.....................o..........................oo.....o..........
.o.o..o............o........oo....o.......o........oo......o...................oo.....o..o...o.o.................................o......................o.................
