232.ox
......................o...............o.ooo...o............o...o..o...o......o..oo...........o.........
........o...........o.....................................o..........................o.................
o...................................................o......................................o...........
.o...o...................................o..............o.............................o................
................o...oo.......................o..o.o.o............o........o........o..................o
....o.o.o.................o..........................o............o............o.....o...o......o.o....
....o.............o....o..o...................................................o........o....o..........
.....o..........................o.........o.oo..................o.o......o..........o..................
............................o.o...o.................o...............o.................o.o.......o......
....o....o........o.o..o...................o.........................................o...............o.
.......................o....................o...............oo........o.................o..............
.......oo......o.............................o....................................o.........o.....o....
..o.........o............o...o....o.................o.....o.......o................o...................
...........o..........o...o.........o.o...........................o.........oo......o..................
.........o............o.o.o..............o................o..............................o.............
......................................o.............o.......o...................o.......o.o.o..........
............o...o.........o...........................o.........o.o.......o........o...................
o.....o.......................o......oo......................o..o.............o.............o....o.....
.........o........................o..................o..o..........o.........o...o..........o..........
..oo..............................o......o..o...o.......................o..............................
.......o....o...................................o...................o..................................
..o.............................o.o...........o.........o..o..........o..o...........o.................
.......o....o.......o.......o...........................o..........................o.......o...........
o.o....oo...oo........o......o..o...............................o....................o..............oo.
...o...o........o...o............o.................................o.........o.............o......o....
.....................o........o....................................o..o.............o.o...o......o.....
..o..o........o.................o..........o..........o............o..o...............o.....o..........
o...........................o.............o....o......o...............o....................o...o.......
.....................................o.o....................o...o..........o...........................
.o..................................o..................o...o........o.........o.......................o
.......o.........o..................o.............o....................o...........o...........o.......
........o....o..o............o.........................o...............................................
....o.......................o........o.................................................................
.....o........o...........................................o.......o....o....................o........o.
.........................o.....................o..................o.......o.................o..........
.........................o....................o...o.o...............o......oo.......................o..
...................................o....oo.ooo.........................................................
o.........o....o............o......................o...........o............o.....o....................
...o..........................o.......o................o...............................................
..o.............o..............................o...........o...........................................
.......o...o..............o....................................o....................................o.o
.............................o..o........o....o........o......o....................o...................
..................................o...o.........o...............o...o............oo.....o..............
.......o..........................o............o............................o....................o.....
........o.............................o..............................................o.o...............
...o........................o..o.......o...............o........o...........................o...o.....o
....o.......o............o......................o............o.........................................
.o....o.......o..oo............................o.oo.o....o.o.o................o......................o.
........o............o...........o...oo......o.....o..................o.........o..oo...............o..
..o.....o....................oo..o.......o................oo........oo.......oo...o....................
.o............................o........o..............................o.o.....o..........o.............
..o.......................o.o............oo.................o.....o.......o.................o.o.....o..
.................................o.......o.............o.........o...............o.....................
.o..................................................o..o..o............................................
.....o......................o.........................o..........................o.......o.............
........o.......o....o.....oo.....o............o.....o.o...................o.......o........o......o...
....o...o..................o..o..o...................................o........................o........
..o.........o.o...........o................o..............................................o.oo...o.....
........................o.................................ooo.o...o........o..............o............
.......o...............o.........................o........o.o..........o..o...........o................
.......o.............o....o......oo......o.........................................o...o...o.....o....o
......o...................o........................................o......o.o..........................
o......o....o..o..............o........o.................o...o....o..........o.........................
.......o....o..........o.......o.......o...........................o.o......................o.....oo...
.............o....o.oo.....................................o...o........o......o.......................
.....o............o..o.....o...................................................................o.......
......oo..................................ooo.........o.....o.....o.....o....o................oo.......
o..............ooo.......................................................o............o............o...
o.......o.....o...o.....o..........................o....o...o.........o...........o.....o.........o....
o........o...........o......o.....o..........o............o..............................o.o.o.........
........................o...o.........o..o...........o.o.......o.........................o.............
....o.....................o.................oo..........o.o..........................o...o.............
....o...........................o...........o..o..............o........................................
........o........o.o.....o....o......................o..........o..o.............oo...o.........o......
............o...........o.o...................o...................o......o.....................o.......
......o.o....o......................o..o.o..........o..........o...........o......o.o..o....o...o......
...o.........o...............................o.................o................o...................o.o
......o...o.............o....................................................................o.........
..o...............o.o...o............o....................o...................o........................
......o........................o..................o.......................................oo..........o
.....o.............o..............................o.......o......................o..oo...o......oo.....
...o........................o...........o............o..................o.......o...o...........o....o.
.................................o....o....o.oo.....o...............o..........o.........o.............
...o.o..........o.............................o...o...o...................o.....o......................
o.................................o...o...........................o......o..........o.....o............
........o...o...................o....o.o........o..o......o......o....o..o...............o........o....
...............................o.............o..............o............o.o.....................o.....
........o......ooo..ooo..........o............................oo...............oo......................
..........o.................o........o......................o.........................................o
..................................o.....oo..o..............o.............o.................o...o.......
.....o.........o.....o.o.........o............o........................o......o...ooo..............o...
........................................o........o.o...o....o.................o...o............o.......
..........o..............o...................................o..o...................o..................
............o......o.o.......o...oo........o...........o....o........o..........o.o...o.......o........
......o............o..............oo.........o......o.........o.......................o.......o...o....
o............o...................o.............o.....oo.......o.......o..o........o....................
o..o...............o.............o.............................................o......o................
.............................o................oo..............................o....................o...
............o.............................o....................o..o.....o.................o.......o..oo
..............o...............o.........o..o............o..o...oo...............................o...o..
.....o............o.o........o.................................o.......o.o..........o................o.
.........o................o.............o........o......................o..............o..........o....
.............................o..o..o..................o..oo................o...............o...o.......
....................o..o...........o.............oo............................o.......................
......................o......o....o.........o....o................o.....................o.....o.....o..
...........o..........o.......o....ooo......o.....o..................o......o..........o...............
o..................................oo...................o....o....o...o..o..........o..................
.......o........................oo.....o..o....................o.................o......o..............
.......................o...........o...o.o.......o..................oo.........................o.......
..........o..........................o....o......o...........o......o.......o.................o........
.....................o..o.o..........o...............................o..o.oo......o....................
.....o..o....................oo..........o...........o...................................o.....o.......
..o.....o...................................o....................o.o............o....................o.
......ooo........o........o......................o....o...........................o.............o......
.................oo.....................o...............o.................oo...o....................o..
.o................o....................................o.o................o........o........o..........
......o.........o.............o.............o...........oo............................o.o...........o..
.........................o.oo......o........................o..................o.......................
...o.o........o.....................o..........................................o.....oo....o.......o..o
.....o..............o.................................................o...........o...............o....
o...o.o............o.......o......................o...o...............o.....o.....................o....
.................o........o.o....o........o......o....o..o...o......o.................o.....o...o......
..............................o........o...........o.....o.....o.....o...o.............o..o......oo...o
.........oo...............o............................................................................
...oo...o......o.........o.............o................o.....................................o........
...................oo....o..o..............o........o.......................o..........................
.........................o.................o................o..................................o...o...
.........................o.......o.....o..........o..........oo..........................o.............
...................oo....................o.....................o...........o....o......................
.....oo.........o..oo.o..o..oo.....o..o..o.................................o........o........o.........
o.o........oo.o.........o..........o.....................o...................o...o............o........
..........o...........................o........................o.....................o.................
.........oo..........oo.o.................o......oo......................o..........o....o.......o..o..
....................o......................o....o.............o.....................o...............o.o
............................o.o............o......................o......................o.o...........
....oo.........o.....o...........................oo........................................o...........
......o..o..o..........o.........o.........o......o.............o.......o..............o.....o.........
.o.......o...................................o........o..................o...................o.........
....................................o.......o..o................................................o......
.............o...................................................o.....................o..........o....
.........o.................................o.........oo........o..............o..o...o.................
...............................o.......o.........o................o....................................
....................................oo............................................................oooo.
.....o.oo.o...........o.....o..........o......................o.........................o.oo...........
.........o........o......................o..o.......................o..........o..................o....
o.............o.............o.......................................................o.......o....o..o..
...o.........o...........o.......................o.o.......o....o...............o.........o............
..o......o...o.............................o..................................................o........
....oo.............o..o....................o....o..o....o............o......o.........o.........o.....o
..........o....o.....................o...o.....o.....o..o...............o.........o....................
..............o......o.....o.oo...........o......o..o.................o...o............................
......o...o..............o.......o.............................o.......................................
....oo.....................o.........o......oo.........o.....o.......o.................................
.......o.........o..o.......o.o......o.....o........o........oo................o.o.........o......o....
....o............o.............o..oo...o......o........oo...........o..................o....o..........
.............................................................................o.....o...................
........o..........o.....o...........o..o.......o.........o.........o...........o..............o.......
......oo.................oo.............o...o.................o.......................o................
...................................o..o.............o.....oo.......o...o.......o...o...................
......o.o...................o............o....................................................o..o.....
..o..o............o.........................o..oo......o...o..o..o.o.........o..........o.....o......o.
...................o....o............................o...................................o....o........
...o..o..o...............o...o........o.....................................o..........................
.................o........o...............o..o......o...........o....................o........o.......o
.....o...........o..o.....o....o.......................o............................o......o...........
...........................................o.................o...............o...oo......o.............
.............................o..o..........o......o.oo..o........................o.........o.......o...
.o...............o..................o.........o....o.........o................o.....................o..
......o....o...................................o.......................o..........................o....
..............................................o......................o..................o......o.....o.
............o........................o...............o.............o....o.....o.........o.o........o.o.
...........o......oo.......o....o...............................o............o......................oo.
.........o......o.........o..o........o...o..............o..................................o.o........
.....................o......................................o..................o...oo.............oo...
.........................................o..........o...........oo..................................o..
.....o.o....o......o....o........o...o...........o..o..................o.................oo............
............o....o.............................o.............................o..o......o...o.......o..o
..........o...........................................o.................o.o..o....o.o......o.o..o......
.oo......................o.......o..................o..........o................o......o............o..
...................o........o.......o....................................o...o..........o..............
..........o..........................o..o.................o...................oo.......o..........o....
....o..................o......................o.....................o..................................
......o...........o...o......................oo.............o..........o...........o....oo..o......o...
.oo.o...........o.....o...o..o....o....................o.............o.........o.........o..o.....o....
....o.................o..........oo.o............o........oo...................o.o........o............
....ooo....................................o.o...................o..........o.....o..............o..o..
..........o.o.o......o....................o...........o.o................o...o...............o.....o...
....o.............o.......o..o......o.....o...............................o......o.........o...........
......o....o.........................o...o........................o.......o..................o..o......
............o..............o..........................o.o....o........o.............o.....o............
.................o.............................o............o....o..........o...oo........oo...........
.........................o......o..o................o..............o..o................................
....o..o........o........o................o.....................................oo.....o........o......
.................o.o....................o..................o........o........o......o..o.....o.........
..................oo........o.........o..o.....o......................oo...............o.........o.....
..o.............o......o..o.......o....o....oo..o.........o........o......................o.....o......
......o.....................o.o.........o...o............o.....o..oo......o...........o................
....o........................................o.o..o..................o..o......................o.......
......................................................o......o.......o............o....................
.......................o......o...o....o......o..............o.........................................
....o...............o....o...........o.....o........o..............o...o..o.........oo...o.............
....o....................................................o.............................................
.o.o..................o...............o...o............o...............................................
....o.....o...o..............o.......o..........o..o..........o......o.........o.................o.....
..o.o..............o..o....o..o........o.............o....................o...o......o.................
.....o.......o............o..........................................................o....o.o..........
....o...o........o....................o....o.............o............o..................o...o.........
......................o...o........o......o..........................o......o....................o..o..
........................o..............o....o...........................o...................o..........
.........o....o..............o.................o..........o............................................
.o....o.o...........o..............o.............o.......o..o.............o............................
............o..........................o..................................................o............
................................o..o................o..........o..o....................................
..o.o.....................o......................o...o...........o..o...........o......................
.o.oo........................................o...................................................o.....
...................o....................................o..........o..o........................o.......
.............o........................................o...oo..............o..o..........o.o............
o....o..........o....o..o.....o....o...........o......................o.................o..............
.o.........o................o.....o.o....................o..o.............o.........o..................
...o...........o......o................o...............................................o...............
..o.o......o...........oo...o.................o..........o..o..................o.......o.........o.....
.o.o................o....o........................o.oo.o.o..................o..........................
.o...........................................o......o...........o.o....................................
......o.................................................o.........o...............o....................
.o....o..........o.............................o................o.......oo................o.o..........
............o..........o...........o............................................o...............o.o....
.o..........o..................o..o...o.....o....................o.o....................o...o..........
.....................................o....o....o......................o.o....oo..........o.............
.............o.................o................o...........o......o...........o...............oo......
.o....................o........o.................................................o.....................
.........o...............o.............................o..........o.......oo.............o.............
o.................................................o.......o.....o.o...........o.........o..o...........
