60.ox
..........o..o.oo..o.....o..o.o..o...o...........o.o.........o..o..o..o..oo.....o.o.....o......o......o......o..o..........o.....o..........o............o........o..o..o.....o...o...oo................o.oo....o.oo..o.oo.......o......o...o..o.o.......oo.............o.............o..o...o....
...oo.o...oo.......o....o...o....o......o...oo......oo...o.....o....o.o.....o.......o...........o................o...o......oo........o.....oo..o.o.o.o..oo..o.........o.o....oo....o.......oo..o..oo..oo......o.......o...oo......o..o..o.o.o...o......o.o...o..o..o....o.....o...ooo............
o...........oooo...o....oo.....o.....oo..o.o..oo.....o.ooo..oo.o......o......o...o.o.....................o...o............o...o...o................o.....o....o....oooo..o.oo....o..o..oo.......oo..........o..ooo...oo.....o..o........o............o....o.o...o.ooooo......o.oo.........o.......
...o...o.......o.o.o........oo........o....oo.....o...o...o..oo...oo...oo...o.o....o...o.....o...o.o.oo.....................o.o....oo...o...........o....o................o...o..ooo.......o.o.o..o....o...o.o.o.o..........o.oo...o...o....o......o.......o...........o......o........o...o.....o
.....o......o.o..o...o........o...oo.o.....o............oo...o.......o.o.....o.oo............o.o....oo...o.....o.o...............ooo...oo........o........o.o....................o..........o.o.o...o.o...o..............o.....o..o........o..o...........o.....o...........oo.o.o.........o......
...o.o..oo..........o.........oo.o...o......ooo.....o.....o........o...........o..o...o...o.............ooo............o...oo.............o....o...o....o...o........o..o...oo...o.o.......o...o..o.o.....o...............o....o..o..................oo.o.....oo..o..o.oooo......................o
....o............o..o.....oo.....o..oo........o..oo......o.....o..o..o.oo.......o..o.oo..o.o.....o.o......o..o............o.....o........o.o.o.o.....ooo........o.o....o.....oo..............o.o..oo...........ooo.o.....o...o.oo....o.o.........o.o....o....o...o.......o.o.oo.o....o...o.....o..
.......o.o........o............ooooo...oo................o.o..o...o..........o..o........o..o...o..o........o........o..o...o.............oo.....o...........o.........o..oo.....o.o.o..oo.....o....o..oo.......o.o..oooo.o.............o..oo...o.oo....o...oo...o...........o...o....o.....o.....
..............o.o..o...oo.......oo.oo...........o....o.........o....o.oo..oo..o...........o.o.....o..o..o..o...o...o..o.......o.o........oo.....o..o..oo....o....o.oooo.o....o......o........o.o..o..............o..oo....o...o...oo...............o.o..o...o.......ooo.........o.......o.........
o.......o.......o.o..o.......oo...oo.oo....o.o.......o..o...o....ooo..o....o...o..o.oo....o...o..o............o..........o.o.......o......o...oo.o......o...o....o..o..............o.o.........o......o.o..................o...........oo..o.oo....o.....o.....o..o.................o..o.o........
.................oo...o.......o.......o...oo......o.........o.....oo.....o.o................o...o.o......o.o...........o..o......oo......oo..................................o........o.o..o...o.oo...o....oo....oo...o.......o.oo...o....o....oo.o....o.ooo.o.....o................oo......o....o
........oo.o..o.oo.o...o...o..o.o.o......oo....o.....o.....o.....o..o...oo.o.o.ooo....o........o............o.o..oo.....o..o...o.......o..o......o.......o.....o.o..o.....o.o.......o......oo...........o....o..o..oo....oo............o.o...o....o...o....o......oo...o...............o....o.o.o.
...o...o......ooo.o....o.....o...o......o...o....o.....o........o....oo...o..o..oo..............oo...o.......o...oo..o..o..o...........o......o....oo.....o..o........o.oo..o.....o..o.........o..........o....o...o........o.o.o...oo...........oo....o..o....o..............oo.............o...o
....o.o...........oo......oo..oo.o.o...o..o.....oo..oo.oo.........o.o..oo...........o.......o.........oo...oo..o..o.....o..oo....o...o.o....oo....o...........o.o........o......o.o....o....o......oo....o.o.......o..o...o......oo.oo.........o......o.o..o.....o.o...o.......o.o..............oo
..........o....o..........o......o.....o.o........oo...oo.............o..o......o...........o......o..o...........o..o................oo.o....o......o...........o.......o....o.......o.o.oo.....o..........oo...............o....o...oo...o.........o.o................o...............oo.o......
......o.............o..o.....o..oo.o......o.........o...o..o.o..o...o.......o......o......o..oo................oo.oo.o.....o....o.....o..o......o...o.........oo..o.......o..........o.o.o............o......o.........o.o.o..o.................o..o.o........o.oo..o.oo....o..........oo.oo.o..o.
..o...oo.o..........o......o.oo..oo....o..o..o...oo.oo....o.........o..o...........o......o.......oo....oo.o...oo...........o....oo..o.........o..o......oo.o.....o..........o....o......o.o..oo...o..o....o.......ooo........o..........o.o...o...oo...oo.......o...oo..oo..o.o...o.oo...........
.....o..o.....oo........o..o..o.o......................o..........o.....o....o...........o........oo...........oo...o..........o.o..........oo.....o..oo.....oo....oo..o.o..o...oo.....o....o...o.....o......oo..........oo..o.....o.....oooo......oooo.oo..o...o.....oo.o.........o....o..o.o....
.oo..o......o...oo.......o.....o.oo......ooo.....o.o...oo.........o.......o......o....o...o.o..o.......oo..o.o.o.............o..oo....oo...o....o.o..oo..o..o....o....oo.............o...oo....oo....o..ooo..o....o..o......oo........ooo.o......o..o..........o......oo...o..oo.o..oo....o......o
........o..o.......o.......o..........o....o....o...o........o.o....o..o........o.o.............o.......o.o.o...............o......o.......oo...o..o.o...........o.o..o.........o........o.o......o.......oo.oo.....oo.o..oo.oo.o...................o......o..o..o.....o...o................oo.o..
..o...o.oo....ooo.................o..o....o..o....o..o......oo......o.........oo.....o........oo........oo......o.....o......o....o....o............o.......o.o.............o....o...........ooo..o.............o....o..o.o......o......oo....o...o.....o..oo...o..........o....o.........o.o..o..
..ooo.....o.....o..o......o.......o....ooo..........ooo.ooo...........o...............o..o........o..oo..o....o.o.o...o.o...........o....o.o..........o....o...........o.....o...o....o....o........o..o.o..oooo.o.o........o.o..o.............o.............o........o......oo.o...o....oo.....o.
...o.........oo...................o......o.....oo...............oo....o...............o...o...o.o....oo........o...o.........o.o.........o..o..........o...o......o....o.o.o....................o...............oo...........o.o......oo....oo.o.o.o..............o...o..............o.o.....ooo..
..oo..oo..o..o.o..o.....o....o.....o..o...o..o....oo.o.............o...ooo..o....o.o..o.o...o.ooo.....o......ooo..............o...oo...........................o...o.o....o.o............o...o...o..o...oo.....o.o............o.........o..oo..o..o...oo...o..o.......o..o.oo...o.........o.......
...oo..o......................o.o..o....oo.......o...ooo...........o......ooo...o..o.....oo......o.oo..o....o...o......oo....o........o.o..o.................o.....o...o.....o.o....oo...................o.oo......ooo.o....oo..o..o....oo..o....oo............o...........o........o...oo.o...o.o
....ooo....o..o.o........o....o.....ooo..o..o...o.o.o....o.o....o....o..o.......o.o..oo........o...ooo..o..o...o.........o....oo.o....o.......oo.....o.o................o....o.o........o..........o...o.......o.....o...........oo..o....o..o.......o.........o..o..o.o....o....o...o.o....oo....
......oo......oooo....o................o.oo......oo.....oo..............o.......o....o................oo.........ooo.....................o.o.o..o...o..o.....o...o..o..o....o........o...................o.o......o.ooo.......oo...o...o........o.....o...ooo.o.o.o.....oo.o......o.....o..ooo.o..
..............o...o..o...o...o...ooo..........o..oo.o..o....o.......ooo..............oo...oo.oo.....o.o..o....oo.......o..........o.....oo.o...oo..............................o..o.o......o..o..oo.......o...o..o......o......oo...o.o..o................oo....o..o....o.o.o......o......o.oo....
...o...oo...o.o..oo...........o...........ooo...oo...o.ooo...o...o....o.....o........ooo.o.o....o.....o..oo.o.....................o....oo...oo..................o..o...oo.o......o............o.......o.......o.....oo........oo...o.o......o.....o.o..o.....o.......o...o...................oo.o.
...........o.............o..oo...............o.......o...o.o.......oo..o.......o....oo..................o..o..o...oo...o....o....o.......o.....o.........o...o.....o....oo.....oo...ooo.o.o.o....o....o......o...oo.o....oo.....o.o...o.o..o...oo...o...o..o....o..o..o...........o..o.......o....
o...o...oooo..o.o.o..o......o..o......oooo...o.......ooo...o.oo...o.o......oo.....o...o.o....o...........oo.o.......oo......o...o..o.......oo....o.o....o.....o.o....o....ooo.....o.....o.o........o......o...o.......o..o.oo........o..o...ooo....o..o...o...............o...o....oo.......o...oo
........oo.....oo...o.o...o.......o..o.oo...o.........o.........o.......oo.o...............o........o.o.oo.......o...oo......o.o.o.oo..o....o.......oo.......o...o...o.o.o...o.........o...o...o......o...o.o.o..o.oo....o..o......o...oo..o..o..o..o.......................o...oo.oo.o.........o.
...................o.....o.....o.o...o.oo..oo.........................o....o.....oo...o......o..o..o......o........o.....o....o..oo.oo...............o....o...o........oo...o.o.........oo.......o.o...o...oo..o.oo.........o.....o.o....o.oo.o......o.........o.........o...oo......o...o..o..oo.
o.................o................o........o...o..........o.ooo..o...ooo............o.oo.oo.......o.o.....oo...........oo.o...o...o......oo............o.............o.o...o..oo.o.......oo..o....o...oo.oooo.....o....o.......o....o...o....o....o...........o......o.........o...o..o..o.......
.o......o.........o......oo...o.oo..................o.....oooo............o......o......o.....ooo..o.........o...o...o.oo.....o..o................o...o.o......oo......o...o...o.o.o..o.......o....o.o..o....o...o......o........o..oo.o.......o......o.....o...o.o.....oo.o......................
o......oo.....oo...o....o...o.....ooo..o.o......ooo..o.o.o....o.......o.....o..o........o.oo.....o..o............o.oo...oo......o........oo.o.o...oo.o..oo..oo.......o.o..o....o..o......o..oo.oo.....o...............o.o.......o...o.......o...o.oo..o.....oo.......o...................o........
......oo.o..o.o....oo...oooo.o..oo...o...........o...ooo......o...o.o...oo..ooo........o...o................o..oo.......o...oo......o.......o..o.o.o...o............oo....o......o..o.o.......o...........o......o..o..............o......oo..o.o.o.....o....o.o...o.o...oo....oo......o.oo.....o.
....o............oo......oo.......oo....o.o...o...o..........o....oo.o.o.o..o....o.o......o..o..ooo......oo..........oo...........o..oo.o.....o..o.o.o.....o.o..o....o..o.o.o..oo..o.....o...oo...o.....oo.....o.......o..o.oo.......o...o...oo...o...o...o............o...................oo.....
..o...........o..o....o..........o..o.........o..o..............oo..o...o........o.oo.o..o..o.o.......oo..oo......o....o.....o.......o..............o....o..oo.......o...o.o...o..................o.........o...............oo......oo.o.......o....o..ooo.o.........o....o.oooo...o.......ooo..o.
...o......o.....o.....o....oo......o...o...o.o..o.oo....o.....o.ooo......o..o..o....o.o........o..oo......o.....o.o.o.....oo.oo....o...o..o.o....o....o.o.oo..oo.o.....o.o.o....o...o....o.o.o...................oo.o.oo....o.o..o.....o.....o.............oo...oo.o....o......o.o..o...o..oo..o..
o.......ooo....o...o...o..........oo..o.....................o.o.....o..oo.o....o.....o.o..o.........o.....o..oo..o...o..................o...o.ooo...........o..o.......o...o..o.......oo..o.o...o.o....o.o.o.......o...o.o............oo..o....o.o........oo...o....oo.o..o....o..........o.o..o..
...oo.o...o......o..o...o.o.o..o.......o......o...........o.........o....o.................o.o........o.....o..oo.o.oooo.o.....o.......o..o..oo....o.o.........o......oo.......ooo....o.o...o.o.....oo..o.....o......................o..oo.........o.o....o..o.....o..o.....o..oo..o.o..o.........
.........o..oo....o...o.......o....oo..o.........o...o.....o......o.oo.o...o..o.....o...o..o.........o.o.o.o....o...o...o..........o..........o....o....o....o........o.o....o................o.o.............oo............o.o.....oo..o.....oo.o.....o........o............o.o..................
....o....o.o....oo....o...o..oo......o.........o.oo...................o...o......oo.......oo.....oo.....o.....oo..oo...........o........o...............................oo...oo.o..o..o........o..........o..o.oo...................o.o.....o.o.....o....o...o..o.o.o...o........o...o.o..........
..ooo....o..o...o..............oo.o..oo.ooo..o....o..........o.........o.o............o......o................o....oooo...........o...o.......o..o...o..oo..........o.o.......o.o.........oo.o.......oo..o...oo...oo..........o..oo..o..o..o......oo......o.o..oo..........o....o..o.....o....o.o.
.........o..o.......oo...o......o.........o..o...............o......oo...o....o..oo.o......oo...o...o.........oo.o.....o..o........o......o..o........o...o..o..................o.....o..o..oo...o...............o.o.......o........o.....o......oo......ooo.........oo.o...o.o.....o...oo...o.o..
...o...o...o......oo.....o........o.o.ooo.o......o....o...o.......o..o.........oo.......o..o.............o..........o......oo.oo.o..o..o...............o.o.....o.o...o..o..................o.....o........................o.o.o..o.o.....o.......o......o..........o..o.........o....o..o.o.....o.
..o..........o....oo..o.....o...o.....o.o..o..o......ooo..o.....o..oo.o..oo.o.o......o......o..o...........o...o.o............o..o..o.o.....oo..................o.o.....o.o.o.o.oo....ooo..o...o.............................o.........o..o.o....o....o.o......oo.ooo....o...........o.o.o.o......
..o.........o...o.....o.o...........o............o.o.o....o...o..o....o.oooo.........oooooo.o...o.o..o..o.ooooo.o..o........o....o......o...o....ooooo.o.....o...o...o....o.......o...oo.....o..o.o.ooo.o.....o................o.....o.....o...o.o.o.......o.oo..o..............o.o..............o
.o.o.o...o........o....o......o.o..o.o.oo............o..o..................o...oo......o.o.....o....o...o..o......oo.o...o...o..o...oo...o.............o.o........o......oo..o.....oo...oo.oo......oo......o........o....o..........o....o...o.......o.....o...........o..........o.....oo.o..o...
....o.....o..........oo.......ooo..o....o..o....oo....o...o......o.....o...o..o..o...o.o..o.....o........o.o....o.o.....o.o...o.oo......oo....o.......o....o.ooo.ooo.........o..o..o..o...o..................o......o..o.....o.....o.o.....o...o..o..o....o...o.oo.......oo...o.......ooo.o.....o.
.....o...............o......o.o...........o.o........o.o.......o..o...o..oo.oo.o.o...oo........oo......o..oo..o.o....o.....o.......o....o....o......................oo..o.....o........o.o..o...o........o..oo..o.o....ooo.....o...........o....oo..o..........o...o...oo..............o.o.o.o....
..........o...o.....o.o..o..o....................o....oo.o.oo........o.o..o..............................o........ooo..oo.ooo...o...oo.......o......o....o.o.........o........o...oo...ooo...o..oo......oo.o...............o.....o...............o..o....o.o.........o.....o...................oo.
........oo.o.oo.........o...o..o..o..........o.........o..........o.........o.......o...o..............o..........................o....o.....o..........oo.........o.o........oo.o.....o..........o...o...o...o.oo...................o.......o......o.........o.............o..o....o..o.oo...o...
...o.o.................o...o.o..o....o..............oo......oo.o...o.....oo.......o.....o.......o..o.......o..........o...oo.o...o....ooo....o....o...o...o..o.oo.o........o.............oo.o................o.o..o...o...........o.............o.......ooo.....o...........o.o..o..oo..o.........
...o.o.....o..o....o.......oo....o.o...........o....oo..o...o.o..ooo.o.o........o.ooo........o..........o.......o...o..o.....ooo..o..o..oo....................o.o...o.o.o.....o.o.o..o..o..o.o..o.o..o...........o......o...........o...oo.o...o..o..o..........................o........o........
.............................o.........o..o.oo....o.........oo.ooo...........o........o...oo.o....o.o............o.o.o.o...o.................oo...o............o..o.....o.............o...o.o..oo.o.....o.........o...o..o..o.........o.....oo....o..oo..o.......oooo.....o....oo....oo.oo....oo.o
.o...o...o..o.o.o.o...oo...........o...oo.o..o..oo.oo..oo...o.....o..o....o...........o.......oo....o....o........oo..o..o......o...............o...o......oo.o...o.oo......oo..o.......oo..oo...o....o.oo.......o..o.o..............oo.ooo...............o....ooo..oo...o......oo.o..o......o....
.o............o.o....oo....o.....o..o.o....oo.....oo...o.................o...o......o.oo.o.....o...o....o...o...oo......oo......o..o........o.oo....o...o...o.o......o.....o.....o......o.o.......o.....o..........o.o..oo..o..o...o.o.......o.......oo......o......oo......o.......oo..o..oo....o
.....................o....o........o.....o..o................o........o......o.......oo.o........o.o......o.......................o..o......o........o........oo.o.o..o..oo...............oo....o......oo..........o...oo............o......oo.....o......o...o...........oo....oo..........o....o
