67.ox
.......oo....o...o.o..
..oo...ooo...ooo...oo.
...o.....o...o...o.oo.
..oo..oo.......o...o.o
..o.ooo...o.oo.o..o...
..o..o...ooo.o........
.ooo.o..oo.o.....o....
oo.......oo.....o.....
......o..ooo..o.o.o...
oo..o.....oo..oo.o..oo
.o.....o...ooooo.o....
oo.o......o......oo.o.
......ooo.....o.o.....
..o....o..o.....oo....
oo....oo...o..o....o..
.........o..oo.oo.oo..
..o..o.o.....oo...o.oo
..o.o....ooo...o...o..
.o..o.o...o..o....o...
...o..o..o...o.oo..o.o
...ooo.o..o...o.......
o.....o.....o........o
......oo.o...oo.....o.
.....oo.oo..o.oooo....
....oo......o.........
....o..oo.....o.......
o......o..o.....o.ooo.
....o.....o.o..o.o..o.
o.o....o....o..o.o....
o..o......oo...o.oooo.
..o...o.o.o.oo...o....
oo.o...o..o..o....o..o
.....o..o...oo.o.oo.oo
.oo.o..ooo.oo..o.o..o.
o..o...o.ooo.o.ooo..o.
oo.o..o...o....o.o..oo
o......o......o..o....
.oo..o....o.o....o....
..o..oo.o.o.oooo...o.o
.....oo..o...o..o..o..
o.oo.....o............
..o...oo........o.oo..
o..o.o...o.....oo.....
..o...o.....o........o
...o.oo...o......o....
..o..o.o...o.o.o.o....
.o........oo...oo.....
.....o....o.....oo.o.o
....o......oo.o...o..o
..o...oo.....oo.oo.o.o
...o.o.......ooooo.o..
...o.....o...o........
o...oo.....oo...ooo...
..o........o.o........
.......oo.o......o...o
.o.....ooo......oo....
..o.o..o....oo.o......
...o...o.o...o.oo.....
........ooo.....oo.o..
..oo.o.........o...o.o
.o....o..oo.oo..o.....
.o..........o...oooo.o
...........ooo........
......oo..o...oo.o...o
o.o.....oo...o....o...
..o.o.o.o..o..........
o...oo...o.o..oo.....o
