79.ox
....o.........o....o.o.o..oo.oo..o..o.......oooo....o..o.o.......ooo...oo......o....oo..oooo
oo....oo.....oo.....o........o.....o..o........o..o...........oo..o.......o..........ooo..o.
o.....ooo....o..o...o....oo...oo..........o.........o.oo......o.....oo...o...o.o.oo...o...oo
.........o.....o............o.o...o...o.....o.o.o....o.o.......o.............oo.....oo.oo.o.
......o.o.o....oo..o...ooo...ooo.o.o.....oo.o..oo...o...oo....o..o......o.......o..oo.......
o.o........o..o..o..........o...o.......o..o..o.o...o...o..o..oo.......o....o...o.o.....o...
o...o..oo...o......oo....o.....o....o.........o....oo.....o.....ooo.o............oo..o..o..o
.o.....o.o....o....oo...o...o.o.oo..........o.o......o........o....o.........o....o.oo.oo...
o....o..o......o.ooo...o....oo...o...o......o.o.o.o.o...o....oo.........o....o..............
...o..o..o.......o..o..oo...o..o.o..o.......o.o...o.......o..o.o..o....o.....oo.....o.......
.......o....o.o.oo....o..o..........o.........o.....oo...............o.o.....o.....o.o.....o
......o..o...o.........o..o........oo..o.oo.........o....o.o.o..o...o......o.o.oo.o.....oooo
.o......o.......oo.o....o.........o......oo......o....ooo..............oo.o...o...........oo
.....o.......oo.........o....oo.o..o......oo.oo.o..oo.oo...oo...o..oooo.o....oo.....oo......
..o..........ooo..o...o.....o...........oo....ooo.o.oo.oo........o.o....o.....o...........o.
...o.....o..o..oo.....oo...o........o..o....o...o..oo..........o..o.o.........o....oo.......
.o...o...o.o..o.ooo.................o............o.........o......o.o.o...o..........oo.....
............o.oo...o..o.o..o......o.......................o....o.o....o.oo..o...o...........
....o....o....o....o....o........o..........o.....oo.o...o.......oo............oo......o..o.
...o.oo.oo...o...o...o..o.o..............o...........oo......o........o......o.....o..o....o
.......o.........o.....o....o....o...o....ooo...oo............o.oo.o......o.......o.........
o.oo.o..ooo......oo.o.o......o.o.....o..o..o.....o...o....ooo.o..o..oo...o...o......o..o....
......o............o.o.................o.....o..o...o..o..o.o.....oo...o......o.o......o..o.
.o..oo.o..oo.o........oooo....o.o.....o.....o....o.....o....o..oo..oo.......oooo..o.......o.
o....oo...o..o.o.oo......oo.o.......o..o.....o.o.o.........oo.o.o...ooo.....o...o..o.o......
o......o.........o....ooo.oo...o...o.....o..oo..o.ooo.....o......o.o...o.o........o.oo......
............o...............o.o.oo...o.o....oo.....o...o...o..o.o................oo..o....o.
.........o.........o...........oo...o...o.o....o..o..o..o.o...o..oo......o......o.o.o.o.o...
o.oo..o....o...o.....o.o.oo......o...o.o...o..o.....o....o.....o.o....oo..o.o...o...o.o.....
..o....o....oo.........o....o...oo..........ooo.....oo.......o......o........ooo............
o...o.....o..o...oo.o.o........o..ooo....o...o...o.o..ooo.oo.oo.o...o...oo..o.o..o.........o
..o...........o.....o..o...o..o......oo......o.o..oo.....o.....oo..o.o..o...oo...o.......o..
.o......o....o.......o...ooo....o...o..o...o.oo.o.....ooo.oo.......o......o.oo..............
o.....oo.o..oo..o..ooo.....o.o....o..........o....o....oo.......o..o...oo..o..o..o...o.o.o..
o.........o....o..ooo..........oooo....o.......o...ooo.o.oo...o..o.........o....oo.o...ooo.o
......o..o.........o..oo.o..o.....o..o.....o.o......o.o.o..o.o......o...oo.o.....o..oo..o..o
...o.o....o.....o..o.oo....o....o.o...oo.......o.....o..oo.o...o..oo.o...oo....oo..oo.o...o.
.........o....oo.o.o...o....o...o..........ooo...o...o.o....oo..o..o.ooo...oo.o....o..o..o.o
..o.o.......oo.o..o...o.o.......o.....o.o...oo....o..o......o..o......oo....o..oo.........o.
o....o.o.o....oo.....o...o......o.o...o.....oo...o.o...o.o.....ooo..o..o....o...o......o...o
.........ooo..oo...........oo...........o.......o..............o...o............o...oo.o...o
.....o.ooo......o......o.....o...o...o......o.o..o..o......o...o....o..o.o.o..o...ooo.o....o
.o......o.o.o...........o......o...oo..oo.................oo..........o...o...o...oo....ooo.
o...o.oo..o.........o.......o...o...o.....o.................o....o.oooo..o...o.o.o...o......
...........o...o.o...........o......oo.o.........o.o.oooo..o.o.o...o......oo.......ooo...o.o
o......o.....o............oo...o.o..oo..........o..........o..o.....o.......o..o..o.o......o
....o.o.o.o..ooo.oo..o..o......o.........o.oo..oo...o...o..oo.......o.....o.o......o..o.....
oo.....oo....ooo...o.o..o..o..o.........o...o...o...o..o.o........o.o..o.o...o...o......o.o.
....o....o..o....o...........ooo......o.oo..oo...o.....o.o....o.o...oo..oo...o...o..o...o.o.
....o.................o.oo...o.oo.o....o..o............ooo.....o.....o.o.o............oo.o..
..o.o..o.....o..ooo...o.o....o.o.o..........o.o.oo....oo...........oo..........o..oo..o.o.o.
o....o.o.o.....oo.o....o..o.o......o...o......o............o....o..o.................o.o.o..
.o..o...o.....o......o.......o...........o.......o....oo...o.o........oo..oo..o..o......o...
....oo.oo.oooo...o..o....ooo.o...o......o..o.........ooo.ooo.....o..oo..o........o..........
.o.........o...o.o.oo..o..o...o..o.o..o....o...ooo...o...o..o..oo.......oo..o.o......oo...oo
..o.o....o.o..o......o..o..o......ooo..o.......o.o....o.....o..o...o..oo.....o...o..........
oo....o....o....o..oooo...oo.........ooo.........o.ooo.....o..o.....o....o.oo...o..o.ooo....
.oo...o.o.....o...o..o..oo..........o.o..o..o.....o..o..o.....o.o.o..........o.o.oo..oo.o...
o.o....o.o..o.o...oo.o.oo.o.o.o.......oo...o...o..oo.ooo.....oo..o.o.........o..o....ooo....
.o............oo.......o.........o.o.o.o....oo..............o..o..oo.o.o...o............o...
...o...oo.........o.........o..o.o..o....oo.o........oo...o..........o.........oo.o..o......
.o..o.o.o.o..o...o....o.o.o..........o.o.........o......o...o...o..o..oo..o.oo....o...oo...o
.oo.o......o......oo...o.o..o....o.o...oo...o....o.......o.o.o.....................o...o..o.
o...oo....o...o..o.....o...........o...o......o.....o....o..o..oo....o.....oo..oo..o.....oo.
.o..o..o.o...o......o.o.o...oo....o......o.....oo..o...o.o.o..o.o.......o...o...o..o...o.oo.
...oo.oo....o..o......ooo...........o..o.o..o...oo............ooo..o......o...o........o....
..o......o........oo.......oo.o.........o....o..o.o...o........o.o..o.........o....o.o.....o
.oo...oo.o...o....o....o..oo.....o..oo......o...o.........o...o.....o........o......o..o.o..
..o.........oo....o.o...o..ooo...o.....o..oo.....o.........o.o.....o...o.........oo....oo..o
.oo.o....o.....................o.o.o.oo.o.o..o.........o.....o...o....oo.o.o..o.......o...o.
.....oo.oo......oo..o....o........o........o.o.o..o..oo.o...o.o.o.o...o.......o.......o...oo
....oo.....o.o.....o....oooo.ooo.....o..o..o..........oo.o..o....o.o...o...o.....o...o......
..o....o..o.oooo...................ooooo....o.o........o.oo....o.o...o.o.o......o..o....o.o.
.....o.......o...o....o.o.....o..o....o..o.o..o.........oo.o.o....o.....o..o..........o...oo
.o...o..........o..........o....o...o..o..........o.o..o................o.oo..o....o.......o
oo.....o...o.....o..o.o....oo....ooo..............oo.........o...o.o.....oo...........o.....
ooo...o..oo.......o...o.......o.oo........oo...o......o.ooo......oo...o..o.........o.o...o..
.o...o....o.....o.ooo...o....o...o.......oo.o.o..ooo...o..oo.....o.o.....o..o.....ooo...oo..
...........o..o.o..oo..........o.....o...o....o................ooo...o..o..o.......oo.....oo
