68.ox
.o.....o.o...........o...................o......o........o........o........o....o.o..............o...........o..o.....................
........o........o......o...o...................o..o.o.....o....o....o..........o.o.....o........o......o.......o...............o.....
...............o.o.o..o...........................o......................o..oo..o........oo...o......o............o............o..o...
......................o..o.......o................o.....o.........o.................................o.....oo.....o..............o.....
.............o.........o....o....o.....o.o...................ooo...o.......................o.......o................................o.
....................o.....o..o................o..o.....................ooo...o....o..o..........o.o..............o....o....o..o.......
..o........................o......o................................o.......o......o.o.o....o.................................o........
..o...o........o.o...................................o....o.............o...o...o...o.....o..o....o...................................
....o.ooooo.............o.............................o...o...............o..............o....................o.......o.....oo........
..........................o............o................o...........................oo....oo........o...........................o..o..
.......oo.o.........o.o....o.............................oo.....o.o.....o......o...................................o...o..............
...............o..................oo.o...o...o....o.........o...o.........oo..o....o..............o...................................
....................o..o...o............o.oo...o......o....o.........o......o.............o.............o.........o.....o...o.o.......
.............o............................o..........o................o..............................................................o
..................o........o.............o....................o.o...........o.......o........o....o.........o...................o.....
.....o.....................o.............o......o.....ooo........o..o..........o.o...........o..o...o..........................oo..o..
..oo.......o........o...........o..o..........o................o.................o.........o.o..................o......o..o....o......
................o.......o.o............................o...........o...........................................o...o...o..............
...o..................o..............o................o.........................o...............................................o.....
...............o.............o....o...........................o................o..o........o.............o......o....o....o....o......
...........o......................o..................................o.o...........................................o.................o
....o...o..........................o......o.o..................o...........o................o..................o...o.o...o.....o......
.......................................o...oo.........o......o....o..o.......o....o...........ooo...o........o........oo.o..........o.
...o...........o...o..........o.......o......................o.o................................................o...o....o...o.o......
.....o......o.....o.......o.......o.....o.............................o..o..o.............o.....o...o..o......o......................o
........o..o..............................o.....o....o...................o..oo...o.o...................o...o..o.......................
..................o.o...o..................o..............................................................o...............o.......o...
...o.................o...................o..........o....o..o.....o................o...............................................o..
o..................o.............o....................................o..............o....o........................o......o.o.........
..........o...............o............oo..o............o.o...o.....o.......o......o.............o........o...........................
o..........................o....o............o.....o..........o....o......................................oo...o..........o...........
......................o...........o..o........o........o................................................o...o....................o...o
.......o.....o...................oo.o..o.............................o..o...o....o.........o.....................o.......o............
..o...oo.....o...o....o......o.......oo............................................o..........o...........o.........o.....o...........
....o....................................o...................................o................o...................oo..................
.o.o..o..............o...........o.........o.........o........oo.......o............o.o....o.................o................oo..o..o
...........o................................o..o...........oo.o..............o..........o.o...o...oo......o..o..........o.............
.o...............o......o.......o.......o................o..........................o..............o.o..o.............oo..............
...o.......o....................o.o................................o...o.o........o..o.......o.o.....o.o.o...........................o
........o.........o................o.....o..o........................................o.....................o....o......o......o......o
o.o....o.............oo....................o.......o.......o....................o.............o.......o.........o................o....
.......o....o...o............o...........o...........................................o................o......o..o.....................
.............................o.o..o.....o..o......o........o....o............o...........o.....o....o......o.o..oo..o..........o.....o
....o..........o...........o.....o.....o................o......o..........oo....ooo....o...o.........o........oo...........oo.o.......
........o.....o......o..o.........o...................o.........................o.....................................................
...o......o................oo....o.......o......o.....o....................oo...........o.....o.....oo.........oo..................o..
............oo..............o.o..o..........oo...................o...o.....................o...........o..............o.......o.......
.........o...............o....o.......o..o.o....ooo......................o.................o...o......o...o...................o......o
....o......o....o.........................o..........o..................................o.................o...........o.o.............
..o..................o....o.....o..........o..................................o..oo.......................................oo..........
......o...................o..........................o...o..o.....o........o.o.........oo.............................o...............
.............oo........o.........................ooo...............o..................o......................o...................oo...
......o..o.o.........................o............o..o........oo............o.......o...................o.oo........................o.
.....o........o...............o.......................oo......o...............o.........o................o....oo....o....o...o........
.o..............o.......o.o.....o.o......o...........o...ooo.....................o..................................................o.
....o.....o..................o..................o........o....o..o.....o.........o............o................o.....o..............o.
....o..o.o............o....o.....o........o......o....o..o...o.......o...o.o................o.................oo...........oo.o......o
...o...............o...............o.................o.................o.....o................o.....oo................................
.o..o.........................o.o.....................o...........o.......o..o...o...............o........o..o.....ooo.......ooo...o..
....................o.................o................................................oo............................o................
........o..o....o.o..o.......o.o............o....o.o...............o......o......o....o..o............o.o..................o.....o....
............................o.o...o..........oo.......................o.oo........................o................................o.o
....o..........o......o...ooo......................o........o................o....o.....o.....oo.......oo.o.....o.....................
.............o.o...o.........o....o.o............o.................oo.....o...........o....o.......................o.........o......o.
o......o..........o........o.....o........o..........o.........o................o.o...................................o...............
.....................o.....oo.......o...o..o............o........o......o......................................o......................
.....o....oo...o..........o.....o......o.........................................o.........oo...o...........o.........o.o...oo........
..................ooo...............o......o..............o...............o..........................o..o...............o........o..o.
