94.ox
..oo.o.o....o...........o............o......oo......o..o.......oo...o.o..o......o.o........o...o...ooo...o..ooo....o..........o...o.o...o....oo.o................o...o.....oo.o...........oo.o.....ooo...o..o..o...o..........oo...o....o..........o.......o.o..o.........o...o.................o.o....
...........o.....o.........o...........o..o.......o..ooo.............o.....o.........o.............oo....o.......oo.............o.................o...........o.....o......o......o..o......o..o.........oo.....oo.......o......o...o...o...o...........o.o...........o......o........o............o...
......o................o.oo......o....o...............ooo.....o.o......ooo.........oo........o.o.o....oo.................o.....oo.......o....ooo.o........................o...o...o........o.o.o......ooo......................o...oo.................o................o.o......oo.o.................o.
..............o..........oo..o......o.o..o.....o...o..o.....o........o.........oo..............oo......o....o....o.......o......o....o............o.o.o.....o...o.....o...o.................o......o..........o....oo......o..o..o..o.....o.o...............o..........o..............o..oo..o......oo.
..............o....o.........o........o...o..o..o...............o...oo............o.....o.o.....o....o.................o...o..oo........oo........oo.....................oo.....o......o...ooo.oo..o.....o...............o.....oo.oo.......o..o..o.............oo....o.o........oo.........o..o.o...o..
........o.........o............o......o.o...o.o.oo..o.oo.....oo......o....o.....oo..o....oo................o.o......o.....oo................oo..o.......o..oo.....o..o..o.o.......o..o..........o......o......o......o.o.......oo..o..........o..o....................o.o...........o.....o.o......o...
..o.........oo...o..o.oo...............o.o...oo....o...o......oo......o..........o.o.....o...o..oo.....o.........o..o.....o...oo....o.........o....o.........oo.....o....o.o...o.....o.............o.o.o...o...........o.o....o........o......o...oo.......o.......o.o.....oo.........o................
....o.............o.o.......................o.......o...................o.............o.o.........o...............oo......o..oo...o.............o......o..o........o.............o.o.....oo..o..o..oo....o...o................o..........o......o...........oo.....o.................oo...o............
....o..............o.....o..o......o.....o.....o.oooo...o......o.......o............o....o...oo.o......o...............o.o..............o..o.o...o..o......oo..o.o........oo.....o......o.......o....................o...o........o.o.......o............o....o.....o.......o..o............o....o.....
.o..o......................o..o......................o.......o..o..o.oo.........o............o..oo................o.............oooo.......oo........o.o...................................o..................o....o.o..oo....o......oo......o...o.oo.............o..o.....o.......o....o........o.....
.o.......o...o...o....o.o..oo...o............................o..............o...............o.o.........oo..............o....o.ooo...oo..........o..o.....o.ooo.....o...o.................o.o..o.....o...o....oo...o.o.......oo........o..o......o...o.o...o.o.oo.....oo...................o.......o..o
........o..o.o............o...o.o.o....o......o....oo..o...o...o....o.....o.o.o.....oo..o....oo......oo.......o.ooo..o...o...........o.....o..o.......o....o..........o.........o....oo.....o..............o.o..o......oo.o.o....o......oo......o...........oo......o...o....................o.....oo..
....o..............o..o...o.......o.oo.oo...o........o.......o...............o.o................o.o...o......o..o..o.....................ooo.o....o......o........oo.............oo..o.o....o..o...oo.......oo.........o......o...o......oo....o.o.ooo...o....o.o.o..o...o.o........o..o....o..o.....o.
.............o.......o....oo..oo..o.............o..o.......o.....o..o....o.o.o.o.....o....oo.o.....oo....o..o.o..o.o.....o.o.......oo.oo.o..o...oo.........o.......o......oo..oo...................o....o.......o..oo...........o.o...oo.o......o......o.o.....oo...o.........o.........o.oo...o......o
.....o...o....o..........oo.......o...............o......o.o.............o.....o....o..o........o..o.o.......oo..o...........o.o.o.o....o.oo.........oooo......o.o.o..oo.o..........o.........o.o.....o.o.....o.o........o.....o....o.oo.......o...o..o............o......o..o.......oo....o...o.o.ooo.
.o..o......o....ooo......oo....o...o.......o........o.......o......o........o...o.........o.........o...........o..o....o.......................o....o.o............o..oo......o............o................o.....o....o..oo..o...............o.......o.....oo.o...o......o......o........o...o..o....
..o.o..o.o..o..................o..o....o...o.....o.oo.o.o......o..........o...o.o.....oo.......o.o.o.............o.o.......o....o................o.o..o..........o........ooo..oo....o..o.........o........o.....o..........o.........o.o..o....o...........o...o......o..o.o................ooooo.oo..
..........o....o..........o....o...........o..o....o...oo.oo..o.........o.......o.o...o.........oo.........o...............o...o....o......oo..........o...............o.....o........o....................o..o...........oo....o.o.o.oooo......o.....oo.o....o..o...............o...................o.
o....o..........o......o......o.....o.......o....o.o...............o..oo.........o...............o..o.........o...........o.o..........o........o........o......o...o............o.o..o.........o.o.o...o....oo.....o.o.o...............o.................o..........ooo..........o...o.o...o.......o..
...........o...........o.o.........o........o....o........o......o.......o.o..o.o.o...o....o.......oooo..o..........oo.........o............o..o.....oo.o....o.o........oo....o...o.o.....o..o.....o..o....o...ooo.oooo..........o...........o....o........o.......o.........o..o.oo..o.....o...o......
.........o......oo.....o...o.................o................o........o........................o...o....o.....................oo..o.....o..oo..o.oo............oo.......o..o.......o....oo...oo.......o..oo..........oo.o...o.....o......o....o.....o.o..ooo..o....o........o..oo..o..o...........o...
......o.ooo...oo.........................o.....o.....o.o..o..o.o........o.....o..oo....o..ooo.o........................................o.o....o......o........o.......oo................oo.....o....o...o......o....o.o..o....o...........oooo.....o.....o............................oo....oo..o....o.
.o.........o.........o.....o......o..............o..oo...o.o.....ooo.o...o................o........oo.o.o....oo.......oo......o.......o...o......oo...............o...........o............o.............o.....o....oo.o..o.................o..o......o....o.......oo....oo............oo....o.o...o.o.
....o........o.oo.oo...o..o....o...o.....................oo..o...o..................oo..o.o.....................oo....oo.......o....o.o.o.o..........o..oo..........o..o.o.................o.........o...o.oo..o...o....o.........o......o..o..o....o..o...o..oo........o...o............o.o.....oo.oo.
o...o.oo...o...........o.o...........o..oo..........o..........o..o........o.o..o......o.o....o..o....ooo............oo...o.....o.o............oo...o.oo.........................o...o..o.o.......o......o....o....o.........................o........o.o.....o.o....o.o....o..........o.o........oo..o
o...........o...o....o............o.oo.o.....oo.......o...................oo.oo.......o....o.o.o........o...........................o....oo..oo..o.....o..o.oo.........o........o...............o...o...........oo....o.............o....o........ooo..........o................o.o...o...............o
.oo........o..oo...............ooo...oo.....o.........o.....o.o.........o.............................oo......o.oo....o...oo...........o...o..o.o.oo...o.o.......o.......o..........oo...oooo....o.......o.ooo...oo...........o.o.............o..o.............o.............ooo..o..o.................
o.......o...o..o...........o..o.o..o.........o....o..............o.o....oo..........o...............oo..o.........o....o..........o..o....o....o.oo..o....o.o....oo..o..oo..o.o.......oo.......o..ooo...o..oo.....o..............o.....o.........o.o........o..o...........o...........o..o............
ooo......o.o......o.oo.......o.............o.o.o...o..o.............o...o.....o.o.oo..........o....o.o...o.......o.....oooo..o...o....o......o....o.....o..o...........o.o......o.....o.o...o..o...oo.............o....o..o...o.......o..ooo...................o.....o...o...................o....o....
ooo..o......o..o.oo..o.o.o................o...o..oo...o........o..............oo.........o..........o.o...o.o.o.oo.o...o.....o...o...oo..........o.o.o...o....o......o.......oo...o...o.....oo.o.........o.o....o.......o.o........o....o..........o.oo............ooo...o............o.oo.o...........
.oo...........o..................oo..o.....o....o........oo........oo...o.o.........o....o...o.................o.........o..............o.o..........oo..o........o...o......o........oo..o.o...........o...o....o.......ooo..o...o.....o.......o.o..o...o.o..o....o..o.............o.o........o.....o.
.o.....o.o..oo.....ooo...oo..o..oo.o.o........o.........o..o..o.................o.............o.o................o........o.o......o........o......o..................o..........o......o...oo...o........o.....o...o.....o..........o...o..o.....o.o..o...o.o.o.....o.....o........o........oo.o.o...o
...........o...................o..o....ooo...o.o.....o......ooo..o.....oo.o...oo....o........o............oo...oo.....o.............o...o..o......o.......o.oo.....o..o....o..o.....o.......o..o.......o...o.ooo.o...o.o..oo....o.......o..o...oo.......oo.o....o.o.............oo.....o...o..oo.......
o......o.o...ooo................o..o...oo..oo....o....o.o...o......o........o........o.o....oo.oo.....oo.....o........o.o.o..ooo.........o..o.o.......ooo........oooo....o.o......oo.......o....o......o.o...o.o.o..o..........o.o..o....o.oo.......o..o.o.o..o.....o.........o....o.o...oooo...o......
.......o..o.................o......o.......o....................o..o........o.o.o........o....o.o...............oo..o......o........o...o..o...o..o...o.........o.........o..o.....o......oo..........o.....o..........o......oo.o...oo.o........ooo.....o....o.........o....o...........o....o.o.o..oo
...o.......o....o....o.o.o........o.............................o..............o........oo.........o...oo.o..o.....o............oo.......o..o.....o...........................oo......oo..o.oo.oo.....o.oo.....o.....o.........o.......o..................o..........o......o....o.oo.o......o....o....
.o...ooo...oo....o......oo.........ooo...ooo.....................o....o............o..o..o.o....o.............o.o....o....oo..o...o.....o..o....................o....o.o.oo..o.o............o...o...oo...o.....o....o............o...oo..o.................o..oo.o.....o.o...o..o.....oo.o......ooo....
............o....o.oo..oo.......o..o...o................ooo........o...................o.....o....................o........o...o...o......oo.....o..o........oo...o..o.o....o.o.....o.........oo..........o....................o........oo.................o.........o...............o..........oo..o..
.........o...oo....o.oo........oo..o......o.oo......o..o.....o.....ooo....oo.oo..o.oo..o....o...........o...o...o........o.....o....o.........ooo...o.o.....o......o...o..oo........o.o.............o..o.oo...........oo.......................................o.......o..o........o..o........o.......
...o............o.o...............o...................o...o...o....o...............o..o..o.........o....o..o..........o..........oo................o.....o.o.o...........o.o..o.o.............o........oo...o..o...o..o......o..o..o.............o............oo........o............o..o..o....oo..ooo
......o.........o........o....o...o..o..........o......oo.......o.......o......................oo..oo....o.....o.....o...o.o....o.....o.........o...o............o.....o...o...o.o...o...........o.....o.........o..............o..o.....ooo.......o.o...........o.....o.....oo.....o...o.o...oo...o...
..oo....o....o.....o.oo..o..o.oo.o.o....o...............oo.........o..o...............o...oo......o..............o............o.............................o.............o...o.o.oo......o...oo...................o..o......oo......o..ooo......oo.......o.o..........o.....o.o..o.......o..oo........
.......o...o.......o..........o.....o................o................o..........o.o..oo....ooo....o.o....o.oo.....o.............o....................o......o....o.............o....oo.oo.o......o........o...o..o......oo....................o..o.o...............o.o...o...o....o....o..........o...
.o.o.oo...o...............o......o....o.....o..oo.o.o.......o..........o..o...........o.............o......o...o..........o..ooo..o...........o...o.......ooo.......oo.oo.o..o...o.o.oo...............o............o..o........oo.......o.....oo.......o......o...oo......o..............oo.........o..
.......o..o......oo....o..........o.........o...o.....o......o.o...o.......o......oo.....oo......o...oo....oo...oo..o.........o..o..............oo....o.o.o..........o.o.....o...o..........o......o.....o.o.......o.o.........o.......o..o.o..o.o..o......o.o..........oo......o.oo.....o...oo...o....
.o....o.............o.o.o.....o............o.......o.....o.oo.o.o.........o..........o.....o...o...........oo.....o.......o....o..........oo...oo.....o....o.o.....o...o..o....................o......o.....o..o..oo.o..o..oo..o...o.............o...................o........o.o......o.....o.........
....o.o.o..o....o.o....o.....ooo......oo.oo.....o............o..oo.........o....o.o.o.o......o.o..o.o.o.o...oo............o..o..o....o.....o......o...o........o.........o....o......oo..o....o...o..o...o..o...........o.........o.oo.o.o..o.........o..o...........o.......o....o.....o..o.........o.
o.........o..o......o.......oo....o.o.o..o.o..o.....o...........oo..o.............o.ooo.o.....o....o..o........oo...o...o.o...........o.o....................o.o..o.........o...ooo...o..o.o....o..o........o....o...o............o......oo......o.........o......o.......................o....oo......
..........o..........o.o.ooo.........o...........o.....o.oo...o.......oo.....................o...o...o.o..o.o....o...............ooo.oo..o.o......o....o..o..o....o.o..oo....oo...o.oo..........o..o....oo......o.......o......o...o.o.o.o.......o........oo........o..o...o.oo.o......o.......o.......
....o.....o.o............o.....................ooo..oo.o.o.......o..................o.oo.....o.............o.o........oo....o.......o.....o......oo..........o.......o...o.o..............oo..o....o........o...........o.....o...o..............o.o.o..o.oo.o....o.....o...o........o.......o.........
.o..o...............................o.o.....o...o...o..o..o..............oo...........o..ooo...o.....o...oo....o.......ooo...o..o......o...o.....o..o.....o.o....o...o...........o..............o.......................o..........o...o....o.........o......o.o.o....o............o...o.....o.........
..oo.......o..............o....................o..o........o.......o.........ooo.o.........o...........o.oo.........o.o.o.....o.......o....o...oo.....o....o.oooo...ooo.....o................o......o.....o...o..oo.................oo...o.o.......o.o..o......oo.o.....o........o........o..o.....o.o.
.o....o....o..o..o.....o......o................o.o.o....o.oo..oo...........o.............o...........oo......o...........oooo....o.o.........o.....o.o......o....oo..o.o..o.........o........o....o.o...o........oo.oo...ooo...........o....o....oo.....oo....o...oo....o.o..oo...oo....oo...o.........
.........o.....................o..o.o..oooo..........o.........o........o....oo.o.o.........o.....o..ooo.o.....o......o.o.o.o.ooo..........o.o...........o.o...oo...............oo.o.....o.o.o..o.......oo........oo..o..oo...o.oo..o.......o..............................o...o....o....o..o.o..o.....
.....o......oo.o....o......oo....oo..........o......o...oo...o.......oo.o.........o...o.o.........o...........o....oo....o.......o...............o.............oooo.....o.....o....oo....o.......o.....o...o.o..........o...o.......o..oo..o..oo............o..o.o....o....o........o.o.o........o..o..
o..o........o.o...o...oo............o....o....o.o.....o.o.......o.o...........o....o....................o....o.ooo......o.......o..........o...o...............o...o....o...o..........o.......oooo..........o.....o..........o.................o.........o........o......o...o.......oo.o..o..........
oo.....o.........oo...o.o...oo......o...o....o........o.........o...oo.....o.o.o.o..o....o...o..oo.o....o......o....o......o.o.....o.....o.....o..o...............o....................oo.o.............o.....o...o...o...o..o...........oo.o...oo..oo...o.........o.o..........o......o....oo....oo..o
..o.....o.o.....oo...o..................o.........oo.o.o........o......o.o....oo....oooo...........o..o....o......o.......o.........o...o.........oo.....o.oo..ooo..ooo..oo......o.................o.o.o..........o.o......ooo....o......oo...o.............o.o........oo............o..o......o...o...
.......o.o.......ooo........oo........o........o........o...........o.oo.....o..................o....oo.....o........o.o.......o......o......o.o.o...oo.......o....o..............o........o..................o.ooo.oo..oo.o........o....o..o.......o.o..o......o....o..o.....o............o.o....o....
.......ooo.....o.o....o..o.......o.o.oo...o..oo..o.oo......o..................o...........o......o.o......oo........o.oo.....o......o.o.o.......o......o..o....oo..o..........o..o.o.....o.....o.o.o.o................o...............o..oo..o.o.o......o.o................o.o..............o..o.....o.
.......o...o........o..o..o.o......o..o....ooo.o..............o.........o......................o........o..o..o..o.........o.........o...o...o.oo.o...oo.........o..oo..o.o......o....o....o.o.o.oo..o..o...............o..o...o...............o.......o..o.............o.........o...o.....o..........
...o..........o.....o............o.o.o....oo........o.o....o..o.....o...o....o.o..o.........o..oo..o.o.o...o.......o......ooo.o....o.....oo..............o...o....o............o......o.................o.o..o..o.......o.....oo.o...o.o.....o........oooo...........o.......o...o.o...................
.....o........o..o..o...o.o..................o............o...o......oo.............o..o..o....o...o.....o.....o.....oo..oo...ooo..o.....o....o....o...............o.o.........o................o...o.....o.o.o...o.o.o.oo...............o.........oo.o.o.oo...............................o......o..o.
o.......o..................o......oo.....o.o......o...............o..........o.......o....o..o....o........o...........oo..o.....oo.oo.o...o....o..o.oo.o..o..o...........o.......o...........o..........o...........o..........o.o...o.o..o.oo.o..oo....o..o.o.....o.......oo........o......oo........
.........oo...o.oo.........o............o...o...........ooo..ooo.........o....o......o....o........oo.oo.....o.........o..oo...........oo.o........o...o..o..oo...o.oo......ooo..........o.....oo.........o........o........o.o......o......o.o....o..o...o.oo..o...o.....o.......o.o.......o..........
....o..oo.oo..o.o.o..oo....o.o....o...o..................o.o................o.....o...oo....oo..o.....o....o...........o.o...o.............oo...................o..oo.....ooo..........o....o............o...........o.oo............ooo.oo.........o.............o.ooo......o.......oo.....o..........
.................o..o.......oo...o...........o.......o..o.o.o.o.o.o......ooo...o.....o........o.......o...............o..o........o..o.o..o.o..o.......o.....o...o.......o......o..o...o.o....o..o.....................o.oo.o...........o........o........oo..o............oo...o..o..o..oo...oo....o..
..o...o...........o.o....o................o.o.....o..........oo.oo......o...o.....o...o..o...o..o..........o.....o....o.....oo.o..oo..o.....o..o.....oo...o.................o.o....o.........o...o..........o.....o...o.............o...........o..o....o.........o...............o...o.oo..oo.........
o....................o........oo.....o...................oo....o.o.............o..o..o..o..o...oo...o.....o..o....o...o...o...o.o.o.o...o....o..............o......o...o..o..oo........o....o....o...............................o.o..o........o...................................oo.........oo.......
....oo...o........o............o..o........o........o...ooooo.....o....o.....................o.o..o.o..o.....o...o......o.....o.o..........o....o....o...o.oo...o.............o.......o....oo.o.o........oo..o.......o.o.o..o..ooo.............oo..o..o........................o..........o............
................o.o..oo...o..o.........o..o.o..o.oo............o..o...........oo.......o.....o...........o...oo....oo..oo...o...........................o.o.oo....o.....o..........o.o..oo...o..o.........o.o.....oo...oo..o.................o.......................o...........o.........o.ooo..o..o.
.......o.o.........................o..............o..o.oo....ooo............o......................o.....o..............o..o.o.o..o.......................oo......o...o...o.oo...o..o...o......o...................o.......o...o.....o.o....o.........oo............o.......o..............o..o....o...
.o..o..............o.o.o.oo.....o....o....o..........o.....o..o..o.o.oo.............o.............o.............oo...oo....o............o.o.........o..o......o.....oo....o........o......o....o........o.......o....oo....ooo...o.o..o......o............o..o........o.....o....o.o.oo.........o......
....o...........o.o...........................o.o...o.o..............o...o...o..o.............o.....oo.o.......o.....oo............o..............o.oo....o.........o....o...o..oo.oooo.....o..o......oo..................o....o.oo..o.o.o...............o...o..o.....o....o...oo..........o.......o...
o....o.o.........o.....o..o.o.o...............ooo.o.........o.o.o............o..o......o.o....o.....o........oo....o............o.o....o..oo.........o..............oo........o.......o..o....o.....o..........o.......................o..o.o....o....o.o..o..................o.....o....o....o...o....
.o...............oo..oo....o...o.o..o.o.....o.......o.......o.o.o................o.o..o..o..o.........o....o.........o..o.o....o..........o..o...o..o......o...o....o..o..o.......o....o.o...........o...o.o.......o..o..oo...o........oo.........oo..........o.....o.................o.....o.o.o.....o
..o...o..oo............ooo...............o........oo..................o...o....o....oo..o.....o.....................o.o....oo.oo..........o........oo............o..........o.....................o.o..........o..o..o..o......o..o..o......o...o..o......o.o.............o.........o...o..o...o.......
.o..........o....o.o.o...o..o.....oo.............o.o.o.......oo...........ooo....o.o..o........o...o...o....o......o.......o..ooo....o.................oo...o....................o....ooooo.....o.........ooo............o..............oo..o....o........oo..o.ooo..........oo............o.....o.o...
.o.....o....o.o......o..o....o..o...o..................o.o......o...oo.oo...oo.o.................o...o.........oo..oo.....o.o....oo.o.oo...........o.o......o...........o...o...o.oo.............oo.....o..o.o.............oo....o......o......o..o.....o.o..ooo....ooo.........o.....o.o...oo.........
o....o..o...o....o......o...o..o.......o...o.o.........oo...o................o.......ooo..o.o.........ooo....o......................oo.....o.........o.o...o.....................o........o......o.....o..o.oo..o....o..........o.o........o.........o...oo.o....o.o.o.o..o...o.......o....oo..........
.o...o....o.....o........oo....oo..o..o...o.....o.o.........o.........oo...o.o...o..................o...o............o.o........o.o.......o..o...o..o.....o.....o...................o.o.......................................o.o....o..........o......o....oo..........o.......o.o.................o..
....................oo..o..o.......ooo.....oo.......o..........oo.....o.o.....o..........oo..o..ooo....oo......oo......oo.............o.o.oo.........o....................oo..o.....o....o.o.....................o.o..........oo...o..o....o............o.o.................o...................o..o.o.
..o.................o........o....o.oo.....oo....oo.o........o..o.....o.......o.........o.o..o..............ooo.o...o.....o......oo.oo..........o........................o.........o...........o..o.o...................o.o...........o...o..........oo....o..o...o..oo.........o..........o..........o
....o......oo.......oo.......oo.o.o...o..............o.................o.........o.....o......o..o.....o.....o.oo.oo......o..o........o.o......o....o....o.o.o..oo..........oo...o.......o.....o..o.o.....oo.....o...........o........oo...oo.....ooo..o..........oo....o...o.....o.......oo........o..
................o....o..o.oo....................o......o...o.......o....o........o..o..o.oo........o.o....o..o.o.........o...o..o....o.o.o...o......................o...........o................oo......o......o......ooo..oo.......o..o...o..o...........ooo......o..............o.o.o.o.............
.........o....o....o...........o.o.o...o....o.......o.o..o....o...........o..oo...o.............o...o.o.................o.o.....oo.........oo.........oo.....o........o...o.o....o..........o..o.....o........o..............o..o........o.........o...o..o...o.o.....oo........o.......o.....o...o....
........o.......o..........o........o.....o...o..........o.....o....o......ooo..o..........o....................oo.....oo....o.o......o...............o................o..o....o.....o............oo.o..........o........o..o..o.......o..o..........o..oo.............o.o.......o.....ooo...o.........
.....o......o...o.....oo...o.......o......o..o.....ooo..........o.o..o........o...............o......oo....oo.o.o............o.......o.o.ooo..oo.............oo................o.............o......o...........o.o....o......o........o........o....o....o........o.........o.oo.o....o.......o.......
....oo.......oo...........o....o.oo...o.................ooo........o.....o..o..o........oo.............o.o...o..........oo..ooo...................o....oo..oo...oo.o..................o..o..............o...o...............o...o......o........ooo..........o.......oo..o..o..o...o..o....o.....o....o
oo..o.o..o....o..oo..o.oo..o..o.o...........o.o...o...o.o....o....o.o.......o.o......o.o..........o.......o......o......o....o..o.o..o......o...........o....o............o......o...oo....o..............o.o.o...o..............o...o.o...o...o......o.ooo.........o......o...........o......o..o.....
.o.o..o.o...................oo.........o....o.........ooo....o.............o.o.....o.......o...o...o.........o...oo.oooo...oo..o........o...o.o...o..o......o.......o..o...ooo...............o...o......o...o.o...o.o...o.........o....o..o......oo....o..oo.o.....o............oo.ooo......o...o.....o
.oo.........o....o..oo...............o.......o...oo.........o.....o.o..o.o....oo.........o.........o...........o...oo.o.o.................o..oo.......oo..........o.oooo.o.......o..o...o...o..o.o............o..o.....o........o.o.o...o...o.oo.....o.....o.o.o.....o.ooo.o....o..........oo...oo.o.o.
....o....o...o......o..o.........o...........o.o.........o......o.o.....o..o..oo............oo...........o.o.o..o...o..o...............o.....o..........o......o.o...o.............o...o...............o.......o....o................o..o......oo.o.o.o......o.o......oo......o...o......o...o.........
............................o...oo.o.o..o..........o......o.................o....o...........o....o.o.......o.o..o.o......o..o.o...oo.o....o.....o.oo.....ooo.oo....ooo..o.............o..............o..o.......o..o....o...o........o....o....o...........o..................o..............o.o....o.
