81.ox
.......o..o...o.o..ooo.....oo......o......o...o...................o..........oo.o.......o........o.o............oooooo.......
o..o..o..o.o...oo....o.........oo.o.....o....oooo..........o...o..............o...o.oo.o.....o.......o.oo...oo....o..........
....oo..........o...o.o.o.......oo.....o.........o...o.............o...o..o...ooo.o.......o..oo.......o....o.o...oo..o.......
.o.......oo........o..o...............o...........o..o............o......oo...o..oo....o.o..o.......oooo..o..........o.......
..o..o....o..o...o...o.......o...o...o...o..o......o.......o.oo.oo........o.......oo.o.o...o...............o.o...............
oo.....o.......o..oo...oo...o....oo..oo.....o.....o...o.....o...o.......oo.....................o.o..............oo.....o..oo.
o.o..........o.....o......o.o........................o.o...o..ooo.o...o.........o.....o.o.....o......o.......o..........oo...
........o...o...o..................o.o..o.o..oo...o.......o........o...o...o.o.....o..o...oo.......oo.......oo.........o...o.
.o......o.................oooo.o..o..oo.o..oo..o.....o...o.o............oo..............o...o.o.........o.oo.o..o......o.....
...o...o..........o...o..o.............o.........o......o.o......o..o.....................o...o...o...oo.oo............o.....
......o.......o..o...o..o.o.oo..o.o..o.......o.o......o...........o...o......oo.....oo..........o...o.o.o..o........o..o....o
.....o..oo..oo..o.o........o.....o.o...ooo..........oo.o....o....o..o.....o..........o..oo.....ooo..ooo..ooo....o..o......o..
....o.............o...o..o.....o..............oo....o.o...........o...o................o......o....oo..............o.........
oo..o..o.....oo.........o......o...o.............oo..........o.........ooo.......o...o.........o..o.o.............o......o..o
o.o..o..oo.o.o....ooooo..........o.......oo.o.....o.....o.......o.............ooo..o.....o...o......o.......o....o.......oo.o
o.o.........o............oo......o.................o..oo...o....o....o.o....o.....o..............................o.......oo.o
...o.........o............o.o.....ooo........o......oo.....o.....o........o...........o.............oo........o.........o....
.......o......ooo.o...o...o....o.o....o.o....o..o..oo.o.....o........o..oo.oo....ooo...o.o..........................o.......o
.o.......o.o......o.o...o..o.......o......o....o..o.ooo.o.o...o.oo........oo............................o.o.oo.......o.......
.o....oo.o..o........o...oo..o............o......oo......o..........o.....o..o.o.oo......oo...o.ooo......o........o......o...
.o.o......o....oo....o.o..o.......oo...o.o.o..o.....o..o........o.o....o..oo.............o.o....o...oooo.o.............o.o...
..oo..o............o...o.o.o...o..........o.o....o..o...o.o...............o.o.......o.....o.o.o.o.......oo..o.o.....oo.......
..o........oo.oo..o..o.............o....o.o....o....oo...oo..o...o.o.o.....................o.oo............o.....o....o...o..
..o.......o......o.o...o......oo.....o...o.....o....o......o...o.......o........o..o............o.....o.....o.o.oo.....o....o
o..............oo.......o............oo......ooo.............o.o.......o...........o.o...o.o.o...o............o..o.o..oo.....
....o.................o.oo..o..o.o..o.o.o..o....o.....o..o.o.o..........o.oo....o..o.......o......o.....oo..............o.o..
.o............o.ooo.oo.ooo.........o.......o..........o......o.oo..o....o.....o...o....o.o.o..o.......o..o.o.o.........o...o.
.ooo......o...o......................o...o.....oooo.o.o...ooo.....o.......o..............o.....o..o.....o.oo..o...o....o.o...
....o.o..o.o............o.oo.......o........o.o......o........o..o..o.......o......o.......................o.......o.........
....o......o.....o..o...o....ooooo.........o....o....oo.o...o..o..oo..o.......o...oo..oo.........o....o........o.o.....o.o.o.
o..oooo..o....o...............o.......o.o..........o...ooo.........o..oo...o............o.....oo..................o....o.o...
.o.o.........o...ooo.......o...o..ooo..o.o.oo.o..o..o...o..o....o......o.oo.............o.oo..o.................o............
...........oo......oooo.....oo..............o......o..........oo......o.o.........o...o....o......o.............o....o..o.o.o
o...oo........o.......o..oo.o...o.....ooo........ooo...o..o..o...........o.o.....o..........o..o......oo..........o..o...oooo
o..oo.....oo...o....o..o.......oo.oo....o..o............o...o..o..o..oo.................o.............o...o..o...o...o...o...
..o.o...o...o..o....o....o.....o.o...ooo.o.......oo.....o.o....o........o..o..oo............oo......o.o.....ooo....o......oo.
......o...o...o.......................o.ooo.........o....oooooo......o.o................oo......o..oo................o.......
....o.o..............o.o.........o.............o.o..o.....oo..o.....o.........o......o..oo....o...oo..o......o.......o.......
...o.......o..........o....o..o.....oo....oo.o..o.....ooo.o....o.o.o.........o.......o...o...o........o...o.......o...oo....o
o..........o.....o.oo..o...oo..........oo.o....o......oo.....o...o...o.........ooo..o...ooo..........ooo.o...........o.o.....
o..oo..o..o.o.o..oo...o..o...o..o....o........o.................o............oo...ooo...oo...........oooo.o...o..o...o.o.....
...........ooo..........oo...o.......o.......o.......o......o..o...o..........o..oo....o...o.ooo...o..o.......o......o..oo..o
o.o........o.oo........o........o...ooo.o...o....oo.......o..o..o....o.......o.......o..o.o...o..o..oo......ooo.o........o.o.
.o...o....o........o.o.o..o...o...o...o...o..oo...o..o...o.o..o.....o...o..o......o...o.......ooo.....oo...............o.....
.o.....o...........oo...oo...o......o.o..o.o.o...oo....o.o.oo.....o..o...o.........ooooo...o..oo..o........o...oo...o..o.....
...o.o......o.....o...oo......o..o.o...o...o..o...o......o......o.....o.oo.o........o.....o....o..o....o...o.......o.oo.o....
oo.o............o..........o...........o.o.......o..o..o...o..o....o...o......o.o.............o..o...............o..o..oo..oo
.oo..o.........o.....o.....o........o.....o....o.......o........oo.....................o.o...o...ooooo......o.......o..o....o
....o..o..o.......o.......o......o.....ooo..........o...o.o..o.....o.........oo........oo....oo....o..o.............oo.....o.
o.o.o.....o....o.o.........o.oo......o...........o...o....o.....oo.o.......o..o.........oo......o..o.......o.....o.oo.o.....o
................o.oo......o.......oo..o...o............o....o...............o..o.......o..o.o..o..........o....o.....o....o..
.......o...................o......o.o........oo.o.ooo........o............oo.o..o...oo........o.......o..o......oo.........oo
...o....................o.....o.o............ooo.....o.....o..o.oo..o.o.o.o....o.oo....o....o..o..o.....o.o..oo..o.o....o....
o.......o..................o..o...o..oo.oo........o.o.o.....o....o.......o......o.....o.o...........oo.o.....o..o.o.....o....
.....o...............oo.o.o...ooo........o...............o....o..o.........o..........o.........o.o.o.............o.....o....
......o.oo.....ooo...o.........oo...o......o......o.o.o..oo......o........o.o...ooo....oo.o...oo.o......o.......oo........o..
.......................o.......o.............o..o..o......o.o........oo.oooo.oo....o.........o...oo....o...o..o...o........o.
....o...o...............o................o....o.....o.o........oo..o....o.....o....o.o.o.....oo.....oo..oo...o..o.....o..o..o
..oo.....o..o....oo.......o..o..o.............o........oo........o.....o.o.o.o...........o.o.o....o.....o.....oo...o......o..
..o...o................o....o...o.o.....oo...o..o..o....o..o.o....o..o......oo.o...o...o...o............o....o......o...o..oo
o.o..o.o...o....oo...........o..........o..o..o..o.o...........o....o...o.o.o.......o........o..o....o..................o....
....o..o....o.o..o.o..o.......o........o............o.o...........oo..o...o...o.......o.o........o..........oo...............
...o.o..o...o...........oo....o.....o..o...............oo......o....oo....o...o.ooo.oo....o.........o...........o........o...
.......o.o..o..o..............o..o..o..o.oo.o.........o....o....o.......o.....oo....o.....o.o.oo........o.o.ooo...o..o...o..o
o.....................o..o..o.o.......o.....o...oo....o..o.oo.....o......oo..o...o....................o...o....o.o.....o.....
oo....oo..ooo....o...o................o.......oo.......oo....o..o......o....o...o...oo........o..........o.........oo..ooo...
...oo.....o.......oo..o.o..o.........o..........o...o.oo....o..o..o....o.o.....o...oo..o.........o...............oo.........o
.o..o..o.o....o....o......o.....o.......o..............o.............o....o.o...o..o.oo.....o.............o..................
.o..........o.....o.oo..o....oo..................o..o...oo.o..o.............o.......o......o......o.......oooo.o..o......o...
o........o.o..........o..o........o........o......oo......oo..............o...o..o..oo......o..oo....o...o..oo...o..o.......o
o....o......o....o..........o............o......oo....o..o.........oo.......o......o.........o..oo...o....o...oooo.o.oo......
.o.....oo..........o...o.....o.......ooo..o.o....o.oo..o.........ooo..o.......o..o.o......o.....o.....o.o....o.o.oo.....o....
.o.ooooooo......o.......o.o.....o.......oo.......o..........o...............o...o.o..........o.ooo...o..oo....o.o.o......oo..
.......o....o..o.....................o........o.o.o......o.o.............o....o....ooo.............oo.....o....o...o.oo......
.......o....o..................o..o.......o...oo..o.......o.o..o..o.......o....o.........o...o....o..ooo..........o.....o....
......o...o..o...o..o......o...o...o.oo.........o..o..o.........................oo................o....o......o..............
.....o.............o...............o........o.o......o...oo..o...........o........oo......o.....o...oo..o.o.....oo.....o..oo.
.......o..o.o..o.......oo......o.......o.......o......oo.......oo..oo..ooo....................ooo...o.......o........o.oo.o..
.....o.o..o....o........o..........o.......o...o......oo.o....o........o...o.......o...o..........oo..o.....oo....o.o...o.o.o
..o.o..o.........o.o....o......o....o.....o...o....oo...o...oo....o....oo.......o.......o....oo............o.............o...
..o.o.o.o...ooo.o...o.o....o.....o.o.oo...o..o...........oo.o............................o.o..o................o.o..o.o......
