88.ox
................o......o..
.oo......oo..........oo...
..o.o......o......o..o....
........o.......o.........
...o...o........o.........
.o......o.......o...o..o..
...o.....o................
o..o......o...o.......o...
ooo..o..ooo.o....o...oo.o.
o......o.o................
o.....o.o..o....o.ooo.....
o.....o.....o...oo........
....o.ooo......o..o.oo..oo
..o..o..oo..........o.....
................o....oo...
.......o...o.........o..oo
...o.....................o
.oo..o......o.......o.....
.......o....oo.oo...o...o.
o..o............o..o.o....
....oo.......o...........o
o.oo.o.o....o.............
..o..oooooo.o....o.o......
........o.......oo.....o..
..............o..o........
o.o.o...o..............ooo
o.o..o.......o............
.......o.......o.o........
o...o.o..o......o.o.......
.....................o.oo.
..o.o.............o.....o.
o...o.....o...o..oo......o
...oo....o..o....o...o...o
........oo.....o.........o
.....o.oo.o.oo....o.......
....o...........o.oo....o.
.o......o..........o......
..o........o.............o
oo.o...o....o..ooo..oo....
o........oo.o......o.oo...
................o.o..o...o
...o.....o.oo..o......o..o
...o.o...o...oo...o.......
........o.......o.oo...o..
..o......o.ooo..........o.
.......oo.o.......o.......
.....o..o....ooo.o......o.
...o......................
....o.....o....o........oo
..o.o..o................o.
....o......o....o.o.o...oo
..........o.............o.
...oo..o..o...........oo..
.............o....o.....o.
......oo......o......o....
.........o..o..........o..
.......o...o.......oo...o.
..........o...o...........
......o........o.ooo......
.ooo...o........o.........
oo..o..o.o.o............o.
.....o....o.............oo
.o.o.........o...oo.o.o...
....o..o..............oo..
oo..o.oooo........o..o..o.
.....o..o.oo.oo...........
.o.......o.o....o.o.o.o..o
.....oo..................o
..o......o................
.....o..........o....oo...
...o......o....o...o...o..
o..o..o.o.......o....o...o
oo...........o.o.....o....
.oo...............o..o....
.......o.....o...........o
...o.oo.o....o.........o..
...o.......o.......o......
......o...........o.......
...ooo.......o...........o
..oo...........o.o........
....oo..o......o..o.......
.......o......oo..o.......
.......o......o.....o...o.
...o....o......o........o.
o.o....o....o........o....
.............oo.........oo
..............o..........o
o...o.o.......o...........
