64.ox
.o.......o...o.o...o.....o....o.o..o..o..o.....o.o.o.oo....o..o..o...........oo....o...........ooo.o.........oo...
...o........o...oo...o....ooo...o......oo.o.....o.....o.o..o...o.....o....o.....o.o....o..o.....o..o....o...oo...o
...o.........o...o.........o....o...o...oo...o...oo.oo.oo.o....o........ooo..oo..o.o...o..o..o..o..o.o...o.o...o..
.o....oo........o...o...o..o....o..o...o..........oo........o...o.o....o.o..o..o...o...oo..oo...o.o..o......oo....
.oo.o.....o.o.oo....oo.......o.o..o...o......o...o..ooo..o.o....o.oo.o...oo.o.o..oo....o.o.oo.....o.o.ooo.......o.
.o....oo.....oo.o....oooo.o........o.o.......o.o.o.oo...o...o.o......o.oo...o.o....o.o...o.oo.o........o.o....o.o.
o........o.o.o......o..o..o.o.oo...o.o....o....o.o...o...o....o........o.o..ooo....o....o.....o.oo.......o...o...o
........o.o...o.....o.......oo.o..o....o.o.o..oo...o.o..oo.....oo...oo.........o.o.........o.o...o........o.......
......o..o...o...oo.........o........oo.o.........oo...oo.o.o.....oo.......o..ooo....o....o.o........o..o..o.o.o..
.......o........o.o..o.o.oo.o.....oo..oo....o..o..o.o..o......o..o.oo...ooooo..o....oo...o.........o.o..ooo..o..oo
o........o.o...ooo..o....ooo...o........o...o.o........o.........o..o...o.......oo.o..oooooo....o.o....o.o..o....o
oo...o....o....................o.......oo...oo..o....o...............ooo...o.oo...o....o........o..o.oo..oo.....o.
oo..o...o......oo.....o........o.....................o.ooo.......o..oo.o...o...ooo.o.o..o.o.o..o........oo...oo.o.
o.oo..o..............o...oo..oo..o.o..o.oo.....ooo....o..o..oo......oo.....o.oo.o.o..ooo.......o...o....o...o.....
..oo....o..ooo......o..o..o.....o.....o...oo.o...oo...o...oooo..o.....o......o.o.oo..oo...oo.......o....o..ooo....
...o..o..oo.o....o.o.o...o....o.........o.o....o..o..oo.o.......o....ooooo.........o...o.o.o....o.o.....o.o.o..oo.
.o........o..o..o.o.....o....o.o...o.o......o....o.........oo...o.oo.....o.......oo...ooo.o.o.o....o.o.....o...o..
o......oo.......oo......o......ooo.....o..o.......oo.o...o..o..o..o..........o...o..oo.....o.o.......oo....o..oo..
o..oo...o.o.oo...o......o.o.......o...o......o................o.....o.....oo........o..o.o.........o.o...o.......o
...o...o...oo.o.oooo....o....o..oo.......o....oo..o.........o........o..........o.....o.o........o.o......o...o.o.
.................o.o.o..o..o.o.......o.....o...o...o.....o.......oo.o..o..oo.......o.......o.o...o.o......o.......
o........o....ooo....oo.o.o....o...ooo.......oo...o..o..oo........o.oo......o.oo....o......o.o..o.oo.o.o.o..oo..o.
..o.....o..o.o....o..oo.o...o..o..........o.o............o...o.o..........o......o.ooo..o.o...o...ooo......o.o.o..
.o.ooo.oo.oo......o.o.....o.....o..........oo...o...o...oo.ooo..o..o.o....o..o....o.o.....o.oo.o.o........o....o..
o.o.o..o.o.....o.o...o.......o......o.o...o.oo.o..oo......o.o..oo....o......o..ooo.oo...oo......o..o.......o......
.....o..o.o.o.......o.......o........oo..o........oo....ooo.oo.....o..oooo.o..oo......oo....o..o...o......o..o.o..
oo.o..o......oo....o.o.........o......oo..o.o.ooo..o...o.......o.o...o.....o.....o.......oo....oo......o......o.o.
..o.oo...oo.o.o...o....o.......o.oo...o..o...........o..........o..o.o..oo..o....o..ooo..o......o..o.o.o..........
....oo.o......o......o...o........o.oo.o...oo.o....o...o...o..o...o..o.....o.....o...oo..o.......o.o..oo.oo.o.....
.oo.o.oo...o.o....o.o..........o......o..o.....o.....o.........o.o.o...o...o.....oo.o......o.oo....ooo....oo...o..
...o..oo......o......o......o.....o.......o......ooo........oo.oo..o.oo...oo......oo...o.......o....o.....ooo....o
.o....oo.o....o...o...o.......o.o....o..o...o..o..o......o..o...o......o..o..o.....ooo..o.o.o.o....o.o.o..o.o..o.o
...o....o.....oo.o.........o.o.o...o.o..o.oo..ooo....o..........o...o......o.oo......oo...............oo.o..o.....
.o.o..o.o..o.....o.....o......o.....o.........oo.......o..o..o..o..o..oo..o........oo....o...o...........ooo..o...
.........o.......o.o......o.o.oooooo.o.o..........o.o............o...o.o.oo..o.o......o....o...o.......oo.oo..o...
..o...oo.........oo......o...........o.o.oo..o..o.....o.o.o.o...o..o....o............ooo.oo...ooo.o.oooo.o....oo..
.o.o.................oo....o.o.o.....oo..oo..o...o.oo.oo....o..o.o.............oo...o..o..........o..o....o.o.o.o.
...oooo.....o.....oo...o.............o.o.........o....o.....o...o...o....o...o.....o......oo.o.o...ooo.....o....o.
o...ooo.o.....ooo......o..oo.oo....o..ooo....oo...o.o..oo....o.o..o.o...oo.....o.o.o.oo..oooo..o.o........o.o.....
.oo...oo.oooo..o.o.....ooo..o.o.o...o..o.o.o.o....oo....o.oo.o..o......o....o..oo..o.o.oo.o............o........o.
...o.o..o.o..o...o.o..oo...oo.oo......oo............o...o.........o..oo.o.o..o....oo..o..oo.o.o.o.....o...........
oo....o.o...o...o.....o..o....oo..o.o...oo..oo..o.ooo..oo..ooo....o.o......ooo.....o.....o........o..oo.o...oo....
....o.ooo...ooo..........oo.....o.....o..o...o...o...oo..o.o.o..........o...o.o.o......ooo.oo......ooo....o..o..o.
.......ooo....o.o....o.o.o.o..oo.............o..oo...ooo...o.....oo..o....o........o.o.o.o..........oo....oo...oo.
oo..o..o...o...oo.o..o...o..o.....o.......o...oo......o..o......o..ooo..o..o..oo....o.o...o...oo..o.o.o.o...oo...o
........o...oo...o...o.o....oo......o.ooo.....ooo....o......oo....o..o........o.........ooo.o.o..o...oo..o.o......
..o...ooo..o.o...ooo.oo.........o...............o.o..o.........o......oo..........o........o.....o.....o.......oo.
o.....o...oo.......o..........o..o...o.......o.oo.o...oo..o.o......o.o......o.........oo..........o..oooo....o...o
.....................o.o......oo............o...o.o.o........o.......o.oo....oo.o....o..o......o.....o............
o.........o....o..o...o........o..o..................o.o.o.o.oo....o.....o.o...oo.oo......o...ooo.o.o..o.o...oo.oo
..o...oo..o...oo..................o...oo..o.o...o..o.......oo.....ooo.o..........oo.....oo...o..o....o.o.......oo.
..........o.o.............o.......o...o....o...o..............o.....oo..o....oo..o....o....o..o..........oo..oo.o.
o.o.o.....o......o.o..oo..o.o.o..o....o......oo.....o....oo..oo...oo.....o.......oo.........ooo...o.oooo.o........
o......oo..o.o........oo.......o...........o..o.oo..o.oo.....oo..o.o..oo..o............oo.oo....o..o...o.o.o.o.o..
...o.o...o..oo....o..o...ooo...o.o...o.....o.o.o...oo.o....o...o......o........o.o.o..o.....o.ooo............o..o.
....o...o......oo...o.o...o....o.......o....o..o.....ooo.o..o.oo......o.o....o...o..o.......oo.o...o.o....o......o
..o.o..oo.o....oo...........o..o..o.ooo...o.o.o.........o..o.o.....o.o...o.......o....o.o........oo.o...o.....o.o.
.o..oo........o................oo......ooo.o.........o...o......o..o...o....o.ooo.o..ooo....oo.o.....o....ooo...o.
.o.oo..o...o.........o.........o...........o.....o............oo.o...o...........o....o...o...o....o..o...o.o.....
..o.o...o......o....o.ooo..o....o.o...oo.....oo......o......o..o.........o..oo.......o.o..o......o..o..oo.o.oooo..
..o..oo..o........o.....oo.....o.oo.......o..oo.o....o.........oo.....o..oo...o.....oo..........o........o.....o.o
o.o.oo.....o..o....oo..oo....o.....o.o....o....o..o..oo..o.o....o...o..oo..o..o.oo.o.o...........oo.oo.....o..oo.o
.........o.....................o.......o.oo....o.........o....o...o.oo...ooo.o.o..o.ooo.o......o..o...o....oo..o..
......o.oo...o...o...........o.o...oooo..o....o...o..oo...o.o...o.........o.oooo...oo..o.......o.o.o.o.o...o.o...o
