200.ox
...................o................................o.o...............
o.o....o..............................................oo..............
..........o..........o.......................o........o....oo.........
o.......o......o.....o.................................o.....o........
....o.o.o.....o.................................................o.o...
..o.o......................o...............o..............o...........
......o.......o.........oo.........oo..o.......o..........o.........o.
.oo.....................o......................................o......
............................................o..........oo.............
....................o.........................oo..............o.......
..........o......o.........o..o........o..............................
.....................oo.......o...........o.o......oo.o.o...........o.
..o....o...........o.................o....o.......o............o......
..........o..................o..o..o...o..........oo....o.....o.......
.....................o...........o..........o...o...oo.........o....o.
..o.....oo............................................o......o........
..........................o...o.......o...o...............o........o..
.....o......o..........o......o......oo.o................o............
.o.............o................o..............o..........o.......o...
............o.............o.................................oo......o.
.....o..o............o...o.......................o.......oo........o..
.....o...............oo.........................o.o....o.........o....
..o...........o............o..o.....o.o.....o...................o.....
...o..........o.................o............o....o.......o.....o.....
..........o.o......................................o...........o..o...
.....o....o........o.....o...o...o.........o.....o........oo..........
..............................o...o.......o.....o......o..............
.......o.....o..........o...o............o..o...o.....o......o........
...........o...o..o.....o.....o.....o..........o........o.......o.....
......................o..................o.....o........o..o..o.......
o....o.............................o..............................o...
....ooo.o................o......o..........o...o...........o...o......
oo..o.o..oo....o...oo..o......o.o..............o........o.......o.....
.....o.ooo...............o....o...o....o...........o..............o...
......o.........o.o...........o....o...........................o......
....o..................o...o.............o...o.....o.........o........
o.........................................o....................o......
..o........o.............................o......o............o......o.
o.........o..........o................o.......o.............oo....o.o.
.....o....o...................................o.o..o.......o..o.......
................o..............................o..o....o........oo....
..........o..........................o.....o....o.............o.......
....o...o.....o...................ooo........o...o.o..oo..............
...............................o.o.....o.o.......................o....
........................................oo.....o...o.................o
.ooo.........o.o...........o.............o..o.......o.o...............
o...............o..................o...o.........o....o..........oo...
....o...........o...o.o....o...............o..o................o...o..
...o..o...o............o..................o..o..............o.........
..o.....o.....oo.........................o......................o.....
.o....o.....o.....o......oo........o..................................
...............................o..o...............o...................
...........o........o..o..................oo............oo.o.........o
o..o................o.....o...oo...........o....o...o......o.....o....
............o........o......o...o...o..ooo..................o..o.oo...
........o..................o........................o........o.......o
..o....o.o.......o..o......oo..........o......o........o.......oo.....
..........o.........o..o.............oo..........oo................oo.
..................o.o................................o...............o
............................o...o.o..............o............o.......
.o.........o.................o....oo.......o.o..o............o........
.............o.....o...o...o.o..o..............o..o.....o..o..........
.o..........o..............o................o..............oo.........
....................o......o....................o...o.................
.........................o......o......o..............o..o...........o
.....................o.o............o...o.o...o..o.....o..o...........
..o.....o.............o......o...................o.............o......
.....................o.........oo...o..................o...o..........
.....o......................................o.....................o...
............o.o.o..o..o....o.o..o......o......o.......................
.o..o........o...........o.......................o......o.............
o.............o......o......................o......o........o....o....
..o...o....oo............o..............o.....oo.o....................
......o.....o............o...................................o.o......
..o.o.................o..o.......o......o...o..o..........o.oo........
................o....o.o.oo............o.....o....o...................
.............o.................o....o...........o...................o.
..o.o...........o.................................o............o...o..
o........................o...........o........................o...o...
..o..o......o...................o.....................................
...................o..o...........o...............o.........o........o
.......o.....o..o......o.o.........o..................o...............
........o..................................o..o.......o.o.............
o.o..........o...........o.............o......o.................o...o.
..o...o.............o....oo...............o........o.........o..o.....
...........o...o...................o......o.......o.oo........o.......
..............o...o..o..............o.........................oo..o...
...o.............o................o...............o......o............
..............o...........o...o................o......................
.................o........oo..........o...............o.............o.
..o....o...........o...o..o..............o.....o.................o....
...............................................o..........o...........
..o...................o.......................................o..o...o
.....oo..............o......o........o..............................o.
..........o.......o...............oo....o....................o.o......
......o....o.....o..o.....o..........................o............o.o.
..o...o................o.....o.......o..............o............oo.o.
..o........o..o..o..o..............o.......o....o.....................
...o......o...................o......o...................o......o..oo.
.........o...o.....................o.o.............o.......o.......o..
o......................o..............o...........o................o..
...o................o...........o........................o..........o.
.o.......o...o....o..o....o............o......o.............o....o..o.
o.........o.....o....................o..o........oo.o.........o.......
...o...o................................o...............o..o..o...o...
.......o.................o.....o.o..............o.........o..o........
...o............................o...o......o.......o...o....o.o.......
........................o.............................................
.o.o...o...........o......o................o...............o.....o....
o...................o....................o..........o...........o.....
....o...oo.o....o....o.................o.........o...oo.o...o......o..
o.........................o..o.........o.o...........o...o............
o.......o.....o.....o..o.............o...o...o........................
........o.....o.o...................o............................o....
.....o...o....o...................o...................o.............o.
...............................o..o........o.........................o
..............................o.........o.......o......o.......o.o.o..
o.................o.......o.....oo...................o....o...........
o.................o..o...................o..........o......o.o.o......
..............o..o............o......o.....o..o......o.......o..o.....
....o.oo.........o...o................................................
.o......o....................o...................o.................o..
.........o.....o....o.............................o..........o.....o..
....o...............o..........o.oo...............o....oo..o......o..o
..oo..................o.......oo.........o..........o.......o.........
................o........o.............o..............................
..........................................o........o....o....o....o...
........o.....o.....o.....o......o.o.o.oo....o.o......................
...o......................................o...............o.....o.....
..........................o................o.......oo..........o...o..
..o................oo........o.........o..o....................o......
.oo..o.........................o.....oo.o..o..o.o..ooo.....o..........
..o...............o.....................o.......o........o.......o....
......o.....................................o......o.o.......o..o..o..
......o.........o...............o..........o.........o.........o......
...............o......oo....o...............o............o......oo...o
....o........o....................o.......o.......................o...
..............o.o..............o........o.......o..o......o........oo.
.o...o.o.........o..........o...............................o.........
.......o...........o.........................o.................o.....o
..........o.o......o..........o............oo............o....o.......
...........o....o.........o.....................o.......o....o........
..............o.....o............................o....................
.....o......o...............o...................o......o....o........o
.o......o......................o..................o........o.o........
....................o.....o.........o..............o...o..............
.........o..oo.....o.....o.......o...o........................o.......
............o.o......................o..........o...................o.
.....o........................o................................ooo.o..
......o......o.........o.......oo.......o....................o........
o....o......oo...o.....................o................o.............
.o....................o..............o....o.o..o........o.........o...
...oo............o...o.o..................o..oo...o...................
...............oo.......o...o..........o.....o.......o...o............
....o.o.....................................o..........o..............
...o....o..............o..............o............o........o.....o...
o.............o.o...o..o..o....o.oo.......o.....o.oo..o.............o.
.............o.........o..........o.............o.o.....o.......o.....
o.............o................................o.......o..............
.............o.o...........................o...................o......
..o...oo..................o....o.........................o.oo.o.......
.......oo.........o........................oo.....o.....o.....o...o...
....o......o.........o........o.............................o........o
.........o......o......o............o.......oo........o............o..
.....o.......o..........o.......................o........o............
....o....o.o............o.......o...o.......o...........o.............
.o....o....o..........o..........o...o...o...........o..........o....o
o................o.....o..o.....o.......o.o........o......o....o....o.
..o............o.................o......o..............o..............
o.o.....o.................o......o..........o...........o..........o..
oo..........................oo.............o...............o..........
...........ooo..o.o...........o...o.......................o....o..o..o
o.o........o.....o..............o.........................o......o....
..........o......o.......o........o......o......o..........o......o...
.......oo.oo..........o.....oo...o...o........................o.......
....o............o.o..................................................
.....o.......o..o.............o....o..............................o...
..o................................................o..o.o.............
.........o..o............o............o..........o....o...............
............o.........o.................o.........o...................
...................o........o...o.o..ooo.........o.o.o...........o.o.o
..o.......................o..o.........................o....o......o..
...................o.........o......o.......o..oo................o....
...o...o...............o........o...oo...o.......oo...................
...........o..........o......o....oo...............o..................
....o...o..o.o....o.o.......o........oo..oo.........o.................
...o....o.....................o............o..o...................o...
..........oo....o..o.........o..o.....o..........o......o............o
........oo................o..o............................oo..........
............o.o....o......................o....o............o...o....o
...........o........o..o.o..........o....o..............o...o........o
.o...............oo..o...................o..........................o.
.o...oo....o.....o...o..o.........o...............o.......o....o....o.
.......o..........o..............o.........o................o....o....
.......o........o.......o............o.................o.........o....
....................oo..o.....................oo...o....o...........o.
..........o..o.......................o..........................o.o...
..............................o..............o...................o....
......o.........o........o..o.........o..........oo........o.....o....
.........o...o...........o..o..........o...............o.......o....o.
