42.ox
........o.......ooo..ooo....o.......o...........oo........o..o..o.o..ooo.o..............oo....o....oo.....o.......o..oo.....o..o....o..
............o......oo.o..oooo....o..o..........o......o.o...o..o......o......o..........o...o.......o...............o............o.....
.o...............o....o..oooo...o....o.ooo....oo.o...........o..o...o.....oooo....o..oo....o....o.....o....ooo....o..o.o...o........oo.
..o....o.o...o.o..o.o.o..oo....o...o.o........oo....oo..o......o.....o..oooo.....o.......o..o.........o.o...............oo...o..o....o.
......o.....o.o.......oo.o...o..........o.o.....oooo...o.o...o..o...o..ooo..o..oo..ooo...ooo.........o.....o......o..........oo.o....oo
.o.oooo..o..........o.o.o.o.o...oo.o.o.oo..o...........oo.......o.o.o....oo..o....o...o...o.oo.o..o..o.o..ooo........oo.oo...o...o.....
.....oo.o..............o.o...o........o.oo.............o.oo...o.o.oo.o.oooooo....o...oo.........o....oo..oo.o.....oo..............ooo..
o.............o.....o..o..ooo....o.........oo..o.....o.....o..oo..oo.....o...o.oo.......o...o..o......o..oo..........o.o.o.o.....o.....
.o..o.oo...o.o...........o............o.o..o.....o.....oo....o.....o..o..oo..o..o.....o.......o.o....o..ooo.......oo..o......oo.....oo.
....o..o........o.......o..o....o.o.........oo......o..oo.oo..........o.o.........o.o.......o.........o......o......o..oo..o......oo...
o..oo...o...o......o..o.o...o...o.............o..o.o...o...o.....................oo......o...o.......o....o.o...o......o......o.o..o...
.o...o.........o.o...........o.o..o....o.........o...o.o..o...oo..o.......oo.............o........o..oo.o.......o..o....o.............o
..oo..o.....o..o..o.o...o.o...o........o.o.o..o.o....o..............o...o.....o.ooo.......o....o..............oo...o.o...oo..o..o......
..o..oo...o.....o....o..o..o...o.....o....o..oo.....o.........ooo.....o...oooo..o............oo.oo..oo.o.o....oo....oo...o..o.......oo.
..o.....o.o...o.o...o.................o....o.o........o..o...............o..o..o..o........o...............o....o...o...o.o....o....o..
..........o...o.....o.....oo............o...o..o.oo..............o.o........o...........o....o.....o..o.o.o..oo.oo...o............o...o
.o.o...oo.oo......o..o........o......oo.......o.....o...oo..................oo.o...oo.oo.o...............o...o..oo...o...........o...o.
.........o.oo..o..ooo...o.o..oo........oooo.o......o.o..o.....o..o....o.......o.o..oo.o...oo......oo...o.....o.o.o...o...........o...o.
..o.oo...o..o.....oooooo.o....o........o.....o.o....o...o...o..o..o.o..o...o........oo..........o...o....oo.o...o.....oo.oo...o..o..ooo
.o.............o.........o..........o.o............o...o......o.....oo..o..o......oo...o......o....o..o...oo....oo.....o..oo.....o.o...
o...o.o........o...o.....o.........o.....o.......ooo....o.oo...oo......o....o.o.oo...o..o..o...o.oo...o.o.o...o........o..o..o...o.o...
..oo..o...........o.o..o..o..o....oo....o.....ooo.o.o.o.....o..oo.o..o............o..oo...o..o.o.o.o......................o.....o......
.......o.o.o...........oo...o..o..o.......oo....o.ooo.....o.o......o.....o..o.oo.oo......o....o..o.o..ooo.oo..o.......o.....oo..oo.ooo.
.o.o...o...o............oo.oo..oo.............o..o..o....o.....o....o......o.o.oo.o........o..oo.o..o.....oo...o....o.o.....o...o....oo
o....o.......oo...o....o.o..............oo..o.o......o.....o..o.o.....o....oo....oo...o..o.oo..oo.......o.o..oo...o.oo.o..........oo...
..................ooo.......o.........o....o.........o...oo............o....o...........o..oo...oo.....o..oo...o..o....o.o.o...o...o...
.oo...o...o...o.o.oo.o.o.oo.oo...o....o.o.....o...oo..o.oo......oo........o...o..oo.....o..oo......oo.o.o.o...o....o.o.o..o..o....o.o..
.o..o.o....o.......o.o..o...o.....o...ooo.oo.oo.oo.o.oo...o....o.....o....o..o.o..o.o.o.....oo..o.....o....o.o..o...oo....o..o.....o.oo
.....o........o.o...o........o..o......o.oo.o....o.............o.......ooo..o...o.........o...o.o..................o.........o..o.oo.o.
........o.o.o.....oo..oo...o....o.o..o..ooo.......o.oooo.o..o..o.o....o..o..oo......o.....o..........o...............o...o.ooo..o.oo...
..o..o......oo.....o...oo....o..oo...oo...o....oo........o.......o.....ooo..oo..o...o.o....o....o..oo.o.o....o.o..o..o....o.....o.....o
..ooo..o..o..o.....o....o.......oo.o.....o......o.o.oo....o.ooo..oo.o..........o.o....o..o.........o.ooo......o.ooo....o..o.oo...o.....
...oo.o..o....o.....o............o..o......o...o.................o...........oo...o......o..o......o....o.o...o.....o.oo.......o.....o.
...o.o...o..o........o...oooo..o.......o.o....o..o.o.........ooo...o............oo.....o........o....oo.........oo..o.o.o.......oo...o.
oo.......oo.o......o..o..o.o...oo.o...o...o.oo..o....oo.o.......o...............o..ooo..o...ooo..o.....oo.....o......o..o.......o.o.o..
oo....oo...oo...o..o....o..o..o.....o.o............o.o......o.oo.....o.oo..o................o..o..o...oo.......o..o.o....oo..o...o.o..o
.o....o........o...o...o..oo....o.......ooo.............o..o...........o.o.o.........o.o.......o....o..o.......oo..o.o.o.......o...o...
..o..oo..........o......o........o...o...o.o....o....o..oo.o.o.o....o....o.oo....o..o....oo...o.o..o.oo....o..o..o.....oo..o.o...o.o.oo
.........oo.o..o..o...ooooo....o.....o..o.o..o.o.o.oo.oo.o.................o...o..oo.o.........o....oo....oo.ooo......oo......o..oo....
.o...o.....o..................oo.......o.ooo.o.o..........oo.o.....ooo...o.........o..oo......o....o.oo.o..........o.....o.............
o.o..o...o.oo........ooo...o....o....o......oo.....o..o.o.o....o.o.o..o......o...o...o....o.o.oo.oo.....o...o...o..oo..o.o.oo.....o.o..
....oo...o.o.....o..ooo....o.oo....o........o...........oo...oo.......o......o...oo.o.......o..o.............o..o.o.....o...o.o..o.o..o
