177.ox
................................o....o..............o..o...........o...............o..........o...o...........o...
...o...........................o..o..........o....o.............................o..........o.......o...o..........
.o.........................o.....o............................................................o..........o........
.....o......................o..........o....................o...............o..........o........o............o....
................................o..............o.................................................................o
................o.........................................o.......o...............................o.o..........o..
.........o..............o......o....................................o.................................oo........o.
.o.........................o....................................o..o.o.....o.o.......................o........o...
...........................................o......o.......................o..........o...........o...........o....
..............................o..............o..........o........o..........o..o...............o...........o......
..........o....o......................................o....o.o......................................o............o
........o............................o.................................o.......o.o..........o.o...................
..............o...................o.............o.......o.o.....o..............o...o....o...............o.......o.
.........o...........................o................................o...........................o...............
............................o.............o.o.......o..............................................o..............
...............o................o...........................o........o...........o....o...........................
...................................oo...o.o............................................o..............o...........
...........o.....o........o...o..........o.o.......................o....o............o............................
......oo.........................o.........o..........o...........o..........................o....o...............
.......o.........................................o...............o.o................o...o.........................
......o.o........o......o...........................o..........o..........o..........o...o...o...................o
..............o.............................o............o.......o..........o.o......o......................o....o
...............oo....................o.............................o................o.........o.o...........o.....
................o.....................o........o........o.......................oo................o....o..........
........................................o.o.......o.....o.......o...........................................o....o
....................o.o....................o........................o...o..o......................................
...................o.............................o.....................o.....................o....o...............
......................o.o...........o.......................................................o................o....
..............................................................o.o.....o......o....................................
..........................o.........o......................................o....................o...o.....oo......
.......o.............o..................................o.........................................................
....o...............................o.................o...................o................o.........o............
...o............................o.................................................................o.o.............
....o..o..............o.....o.......o.........o.......................................o...........................
.....o..o....................................................o....o..........o........o....o...............o......
............................o.........................................................................o...........
.o.......o.......o...................o................o.......o...................................................
.............................o......o...o........o...o................o..............................oo...........
..o.o.....................o..o.......o.................o.o.o.....o........o.......................................
.......o.........o...............................oo..oo.................................o.........................
...............o................o.......o.......o.......oo.......................o................................
..o................o............................o..................o....o.o.......................................
............o.....o.o............oo........................................o....o.................................
......o...o....oo.....o.............o..............................o..........................o...................
..............o..............o................................o...................o.......o.......................
............o....o....................................................o.....o......o..............................
.........o.o............o.o..............................o...........................................o............
............o............o...........o...........o........................................o..............o........
..............................................................o..o.o.....o.....o..o...................o...........
.....o...........o.........o.....o.....................o...o....o............o........o...........o.o...........o.
......o.......................................o.............o.................o.................................o.
.........................................o...........o.o.....o.....o..................................o...........
.......o..........o........o.....................o...o............................................................
o......o........o..............................o..............o....o..........................o.o.................
............o......o..........o.................o...........o.....o...............................................
...........................o...........................o.............................................o............
............o..o...........o.................o.o......................oo.....o......o.......................o.....
o..................o.......................o.......o.......................o............o.......o...o.....o.......
.............o.................................................o......................................o...........
............o...............o..o.o.o...............oo.o...........................................................
.................o..............o..................................o.................o......o.....................
.......o.....................................o.....................................................o.....o........
.................................o....o............o......................................................o.......
..................................o............................................................................o..
..o.........................................................................................................o.....
................o................o................o................................o..............................
.....................................................o...o..o............o.........oo....o..........o...........o.
..............................o.......o...........................................................................
.............................o...................o...........o...........................................o......o.
.......o.......................oo................o............o................................................o..
...............o.o............o............................................................o..o...o.o......o......
.....o................o...........o......................................o............................o...........
.........................................................................o.......................................o
......o.........o.............o..........o.............o.....................oo................o..................
.o....................o.....................o..................oo.........o.................................o.....
o....o.......................o......................o........oo........................o..........................
o.............o...o..................o.....o.......................................................o..............
..........................................................................o.o.....................................
..............o...............o........................o.......o..o.........o.....o...............................
.......................o...............o...............o.o...o...............................o........ooo.......o.
............o..o.............o......................................................o....................o........
.....o.o.o.............................o.........o......................................................o.........
...............................................................................o...........o.....o................
.............................................................o.........o..............o...........................
..................oo...........................o.o............................................o..................o
.....o.....o........o.......o.......................................o....o.....................................o..
..........................o..........................o.......................o.....................o..............
.....................o....................o.........o..........................................o............o.....
.....o..........o....................................o.......o....................o..............................o
................................o........................o...........o.........................o..........o.....o.
..o.........o................o................o.............o.o.oo................................................
o........................................................o....o..............................................o....
o...................o........o.......o...........................o..o.........................o...................
.........o.o...................o................o............o.....o..........................o....o..............
...o.................................................o.......o..o..........................................o......
....o...........o.........................o..........................o........................o...........o.......
o......o....................o..........................................................oo...............o.....o...
........o................o.........................o........................o.................o...................
...................o............................o................o.........o.............o........................
..............................................o........oo.........................................................
..........................o..o......o..................o.......o........o.........................................
..........o...........o..........o.............o.......o......................o...o.....oo........................
.....................o...o............................o.o............................o......o...............o.o...
...................................o........o............................o...............oo........o.........o....
..........................................o.o....................o........o.........o.........o...............o...
..................o.o..............................o.............o.........o........................o.o...........
...................................o............o................o.........................................o......
.........o..................................................................................o...............o.....
.....................................o........o....................o........................o...................o.
.........................................................................................o....o..o.......o........
...............o...................o........oooo....................o...............o.............................
.o.o.......o....................................................o.....o....o......................................
o......................o.......................................o......................o.....o....o................
......o......................................oo.........................o.....................o..................o
.........o.......................o..........................o....o.................o.........oo...................
.........................o....................................oo.o.....o...............o.o.....................o..
.........................................................o.........o.....o..o....................o.........o......
.................................o.......o..............................................................o.o..o....
.....................................................................o........................................o...
...o.......o..o..................o..o..o.....o.o...............o................................o.................
...................o....o.....o...................................................................................
...............o.o..o....o...oo..o..o..............................o.............o.o......o.o.o...........o.......
..................o..............o...............o.............................................o...o.....o........
.................................o.....................o...o......................................................
.............................o...................o..............o.................................................
..o........o...................................o..o....o........o.o......................oo.......................
...o...............o....o...................................o........o........o................o..................
.....o......o...........................o...............o................................o....................o...
...............................................o....o.o........o.o..............................o.................
.........o..o......................................o..............................o............o................o.
................................o........o..................o.o......................o.......................o....
...................................o..................o...........................................................
........................oo....o..............................................o...........o..............o.......o.
........oo....oo........o....o............o.................o......o.............................o................
....................................o..........o...........................o......................................
..........o...................................................o........o.........................o...........o....
......o.......o......................................o............................................................
.o.o.......o........................................................................o.......o.....................
.......................................o..................o.......................................................
....................o....o......o.o......................o.o....................................................o.
..o..................................o..........oo.o.o..............o..................................o..........
....................................o.o...........o.................................o...............o.........o...
....................o.......o..oo............o.............oo................................oo.............o.....
....................................o..............................o...o...o........................o.............
........................o..............o................o..o......................................o...............
............o........o.....................o.........o.......o...............o........o...........................
..............................o.................................................o.................................
............................o..............o..................oo.............o....................................
..............................oo...........................o..................................o.......o.o.o.......
.o.......o........o...............................................oo..........o...................o.......oooo....
..............o..o.....................o...............o...............o..........................................
..........o...................................o.................o....o.................................o..o....o..
...........................................o...o.......o...........o.........o.............................o......
.....................................o................o.......................o.......o........................o..
...................o............................o.............o..............o.........o..........................
..........o...........o....o.o........................o...........................o.............o.o.o.....o..o....
.........................................o...................o............o............o.................o....o...
...................o...........oo..................o.................oo.....o....o...............o.o..............
....o.............................o.............o...o...........o...............o.................................
.................................o..........o........o.............o...................o...........o...........o..
.....................................................o..........o................o..............o.................
....o.............................o...........o...................................................................
........................................o......o.............o.............o........oo...oo..........o..........o.
..............o.......o..o.............................................o.......................o..o..........o....
.......................o.......o................o....oo..................o................................o.o.....
...........o..o.......o...............o...........o..............................o.........................o.o....
....o..........................o..............o.............o............................o....................o...
.......................................o..............o.....o...o......................o........o...o....o........
..........o....oo.................o...........o................o.......................................o..........
......o....o....................o................o...........................o..........o................o........
.o...................oo.o.........................o..............................................................o
...........................o..................................................oo..................................
o................o................................o.....o....................o....................................
.....o.........................oo................o.oo.........o..........................o............o...........
............oo.......o.......o....o........o..o.........oo..........o.....................................o.......
........................................................................o..................o.o....o.....o.........
.....o.o...............o....o....o.....o..o...........o.....................................................o.....
